antropoida = homsimila
antropologo = homsciencisto, homstudanto
antropologio = homscienco, homesploro 
antroponimo = homnomo
antroponimio = homnomoscienco
apelo = nomvoko
apendicito = apendicinflamo
aperta = malfermita, subĉiela, publika 
aperti = malfermi, esti malfermita
aperturo = = truo
apostato = forlasinto de religio, defalinto (de religio aŭ politika partio)
apoteozo = diigo, glorigo, triumfo
apozicio = apudmeto
apreci = ŝati, aprezi. Vidu Ssv plio 8. 
aprezi = ŝati, admiri. Vidu Ssv plio 8.
aprilo = la 4a monato 
Aprutio = Abruco
aptenodito = granda pingveno, grandpingveno
apterigo = kivio (la birdo)
apunto = mankantaj moneroj (por finpagi la precizan prezon), monerprovizo (ekzemple: la pasaĝeroj devas mem havigi la apunton, aĉetante sian bileton).
arakido = ternukso
arasao = gujaveto
arbedo = trunkarbusto, tufarbusto
arĥi- = ĉef-
arĥipelago = insularo
ariero = malantaŭo. Vidu ankaŭ Ssv plio 17
ariergardo = malantaŭa taĉmento, malantaŭirantoj
arierulo = defendanto
arieso = virŝafo 
ario = melodio
arĥaika = malnoviĝinta
arĥaismo = malnovaĵo
arĥeologio = antikvscienco 
arkaika = arĥaika
arkaismo = arĥaismo, arĥaikaĵo
arkano = mistero
arkanĝelo = ĉefanĝelo
arkeologio = arĥeologio 
arketipo = pratipo, ĉeftipo
arki- = ĉef-
arkipelago = insularo
arkitekto = arĥitekturisto, konstruprojektisto
arkitekturo = arĥitekturo [fun], konstruprojektado
armistico = milithaltigo, milithaltiga kontrakt-o
arondisemento = subdistrikto
arsenalo = armilejo; armilaro; (en la senco de la itala vorto arsenale) ŝipfarejo
artefarita = homfarita
artiklo = varo, komercaĵo
ascendi = supreniri
asidua = diligenta, daŭre aganta
asimili = ensorbi, enpreni, alproprigi, malfremdigi, igi laŭa, internigi, unuecigi, similigi
asistanto = helpanto 
aspekti = elrigardi
aspergi = akvumi, surverŝi, akvoverŝi, akvodoni 
aspra = malglata, raspa
asteroido = planedeto
astro = (en komuna lingvo plej ofte) stelo, (en scienca lingvo) kosma objekto
astrologo = steldivenisto, stelaŭguristo, astrodivenisto
astrologio = steldiveno, stelaŭgurado, astrodivenado
astronaŭto = kosmovojaĝisto
astronaŭtiko = kosmovojaĝado; kosmovojaĝscienco
astronomo = astrosciencisto
astronomio = astroscienco
ate = fare de
ateismo = sendiismo, dineismo 
ateisto = nekredanto, nekredulo, dineanto, sendiulo
ateliero = laborgrupo, manlaborejo 
ateljero = laborgrupo, manlaborejo 
atenui = malfortigi
atlaso = (en la signifo de maparo) maparo; (kiel ŝtofo) atlaso = sateno
-atoro = -anto, -isto, -ilo, maŝino (laŭ la signifo en la unuopa okazo)
atrakcio = allogaĵo
atraktiva = alloga
aŭbado = matenruĝa/matena serenado
aŭdi- = aŭd-
aŭdio- = aŭd-
aŭguro = antaŭdiveno, antaŭsigno 
aŭgusto = la 8a monato 
aŭkcii = konkure vendi 
aŭriklo = orelkonko
aŭspicio = subteno 
aŭstera = severmora 
aŭstrala = suda
aŭtarcio = ekonomia memsufiĉo/sendependeco, memproduktado, fermita ekonomio
aŭtarkio = politika sendependeco, memregado
aŭtentika = vera, vereca, veraĵa 
aŭtisto = aŭtismulo, memcentrulo, enfermulo
aŭto- = mem, memfunkcia
aŭtodidakte = memlerne, meminstrue
aŭtodidakto = meminstruito, memlernanto 
aŭtodidaktismo = memlernado
aŭtokrato = solregisto, solreganto
aŭtokratio = solrego, solregado, solregeco
aŭtoktono = praloĝanto, indiĝeno 
aŭtostrado = aŭtovojo
aŭtoŝoseo = aŭtovojo
avangardo = (en la armea signifo) antaŭtaĉmento, antaŭirantoj; (en la artisma signifo) pioniro
avano = antaŭo
avanulo = atakanto
averaĝo = meznombro, mezumo
averio = difekto
averso = antaŭflanko
avio = aviadilo
babordo = maldekstra flanko (de ŝipo)
bagaĝo = pakaĵo, pakaĵaro 
bagno = punlaborejo 
bagro = fosmaŝino, skrapmaŝino
bajadero = hinda dancistino
bajto = bitoko 
bakalaŭro (en la senco de lernej-fininto) = lernejfininto, abituriento
bakŝiŝo = ŝmirmono, dankmono, trinkmono
baktericido = bakterimortigaĵo, bakterimortigilo
balanco = ekvilibro
balancilo = baskulo
balancumi = ekvilibrumi
balancelo = velŝipeto
baledo = baleto 
balistiko = paf(-aĵo)-scienco
baloti = voĉdoni (per voĉdonilo)
balotilo = voĉdonilo 
baltika = balta
balustro = (balustrada) koloneto
bando= muzikistaro
banero = banderolo, reklambendo
bangalo = (unuetaĝa) (feri)dom(et)o
bankedo = festeno
bankiero = bankestro, bankposedanto
bankizo = glacitavolego
banuso = (orienteŭropa) vicreĝo
baraterio = fraŭdo (de ŝipestro / de ŝipanaro)
Barato = Hindujo
barbio = barbfiŝo
barbiro = frizisto por viroj, barbisto
bareliefo = malaltreliefo
baremo = kalkultabelo
bariero = barilo
barkano = lunarkforma sablomonteto
barto = balenlameno, balenosto 
basa = malalta, malfrua (en la okazo de 'Basa Imperio') 
basbalo = bazpilkado 
basebalo = bazpilkado 
baseno = naĝejo
basiero = kurzofala spekulanto
basketbalo = korbopilkado
baterio = pilo ; pilaro
batrako = senvostulo; amfibio
batuo = pelĉasado
baŭmi = stariĝi (parolante pri ĉevalo)
bavi = salivumi 
bavo = salivumo, ŝaŭmo, muko (en difinitaj bestaj kuntekstoj); salivaĉo (se oni volas prezenti malŝatan nuancon) 
bavuro = elstaraĵo, neglataĵo
bazbalo = bazpilko 
bei = (ŝafe) bleki
bebo = infaneto, suĉinfano 
beletro = belliteraturo, arta literaturo
belfrido = urboturo, gardoturo, gvatoturo, alarma turo
Belgrado = Beogrado
bendo = (en la geografiaj esprimoj: ekzemple bendo de Gazao) strio ; (se temas pri ŝtofo) rubando 
benigna = negrava, nedanĝera 
benko = bordo, riverbordo
berbero = amaziĥo
berserko = (skandinava) furioza batalanto
bestia = besteca
bestio = besto, bestulo, besta homo, sovaĝa besto 
bestselero = plej vendata libro
beta = greka bo
Bharato = Barato
bi- = du-, ambaŭ 
bibliofila = libroŝatanta, librema
bibliofilio = libroamemo, linrokolektado
bibliofilo = librokolektanto, libroŝatanto, libroamanto
bibliografo = fakulo pri libroj 
bibliografio = referencoj, fontaro, fontolisto
bibliomanio = libromanio
biblioteko = librejo, librotenejo, librarejo 
bido = pilketo, globeto 
bideo = sidkuvo, sidpelvo
bienalo = dujara prezentado 
bifsteko = bovtranĉaĵo
bijekcio = dissurĵeto, ĉioncelanta unualunufunkcio, funkcio unualunu kaj sura
bilabialo = dulipa konsonanto
bilaterala = duflanka
bildstrio = bildrakonto 
biliono = (en la senco de 1.000.000.000.000) miliono da milionoj; (en la senco de 1.000.000.000) miliardo (entute evitinda pro malsama signifo en malsamaj landoj)
bio- = viv-, vivaĵ-
biodiverseco = biologia diverseco, viv-(aĵ-)diverseco
biografo = vivpriskribverkisto
biografio = vivpriskribo
biogramo = vivpriskribo
biologio = viv(aĵ)scienco
biontologio = vivscienco, biologio
biorubo = vivaĵorubo, humigebla rubo
biri = lokdetermini, navigacii
birilo = lokdeterminilo; (por ilo kiu kombinas lokdeterminadon kaj vojplanadon) navigaciilo
bis! = ree!, denove! 
bisako = dusako, dupoŝa sako
bisekci = dusekci, duonsekci, tranĉi je du partoj
biseksa = duseksa, ambaŭseksa
bislamo = la bislama lingvo
bizara = stranga, eksterordinara
bizneso = komerco, negoco
blagi = ŝerce mensogi: 
blami = kulpigi, riproĉi
blazo = (haŭta) vezik(et)o
blinda = senfenestra
blino = rusa patkuko
blinko = intermita lumo
blogo = reta taglibro, rettaglibro, retotaglibro
blokhaŭso = (malgranda) fortikaĵo; kirasita pafejo
blufi = ŝajnigi (en kartoludo), mensoge trompi 
bluĝino = (blua) ĝinzo; ĝinzoŝtofo
boaco = norda cervo 
bobo = sportglitveturilo, sportsledo
bobelo = veziko , aerveziko
bobo- = uzebla duobligo de la prefikso "bo-", sed, se ekzistas ebleco miskompreni, oni prefere priskribu la celatan rilaton, ekzemple por bobofrato: edzo de bofratino aŭ edzo de fratino de bofrato, ktp. 
boji = (hunde) bleki 
boksi = pugnobatali, pugnadi 
boluso = (granda) pilolo, pilolego
bonifiko = aldona/kroma avantaĝo, prezoredukto (laŭ Krause), donaco, kompenso, kromsalajro
bonzo = moŝtulo
boreala = norda 
borno = klemo
bosko = (bele aranĝita) arbareto
boso = ĝibo 
botaniko = kreskaĵoscienco 
braceleto = ornama brakringo/piedringo, ĉirkaŭmano
brakicefalo = mallongkapulo, larĝkapulo
bravisime = bonege, lertege
Brazilio (ĉef-urbo de Brazilo) = Braziljo
brevo = papa letero 
breviero = (katolika) pastra preĝolibro, preĝlibro
brezi = ekroste stufi
brioĉo = (francstila, dolĉa) laktobulko; lunarka bulko, lunarka kuko (por la matenmanĝa kuko/bulko nomata "croissant" en pluraj etnaj lingvoj)
brizo = venteto
brodkasti = dissendi (per radio, televido)
bruna = nigra
brunĉo = frutagmanĝo, matentagmanĝo, mezmatenmanĝo
bruska =-malmilda, senpacienca, akra, malĝentila
brutto = malneta pezo
BuenosAjreso = Bonaero
budeno = sangokolbaso 
budĝeto = buĝet•o 
Budho = Budao
budhismo = budaismo
bufono = amuzisto
bugri = anusfiki, pugseksumi
bujabeso = (provenca) fiŝsupo
bukceno = (en la senco de antikva trumpeto) (roma) trumpeto; (en la senco de mara molusko kun spirala konko) marheliko
bukmekro = vetperisto 
buldozo = ŝovtraktoro, fosveturilo
buleo = papa/reĝa dekreto
bulio = amika renkontiĝo, (en sporto) enludigo
bullo = papa/reĝa dekreto
bunta = multkolora, plurkolora, diverskolora, varikolora
burgo = (fortikigita) kastelo, fortikaĵo
burgrafo = kastelgrafo
buroo = oficejo, estraro
burso = monujo 
busolo = kompaso
buti = terumi, kovri per tero (kreskaĵon)
C = 100, 100a 
campo = (besto-)piedo, manaĉo 
Cejlono = Srilanko
celiakio = glutenmalsano, glutennetolero
celebri = festi, solenigi 
celibato = senedzeco, needziĝo
celulo = ĉelo
centenario = centjariĝo, jarcento
centi- = centono [rimarko: en la vorto 'centimetro' kaj similaj 'centi' estas parto de unu tuta radiko 'centimetr-' kaj similaj]
centralo = (en la senco de energi-produktejo) energiejo, (en la senco de elektroproduktejo aŭ distribuejo) elektroproduktejo, centr-a elektr-ej-o, (en la senco de centra telefonejo) centr-a telefon-ej-o
centralizi = centrigi
centrifuga = decentra
centripeta = alcentra
cerealo = greno, matengrenaĵo (en la senco de grenoj manĝataj en la mateno ofte kun lakto)
cerebelo = etcerbo, cerbeto
cerebro = grandcerbo, egcerbo
certa (tuj antaŭ substantivo, kiam ne temas pri certeco, sendubeco) = iu, forlaso de "certa" 
cerumeno = orelvakso
ci (al nur unu homo) = vi (ĝenerale)
cianoforo = blupigmentĉelo, blupigmentoĉelo, blupigmenta ĉelo
cicero = cicerona literspeco
cico = mampinto
cicumo = suĉilo
ciklo = velocipedo, (en kunmetaĵoj) -bicklo, -radilo (vidu la liniojn pri "motorciklo", "unuciklo" kaj "triciklo")
ciklono = kirloŝtormo
cimo = (program-)eraro 
cirkonspekta = singardema
cirkuli = trafiki 
(kurta) cirkvito = fuŝkontakto, tuŝkontakto
cis = maltrans, ĉiflanke de
citologio = ĉelbiologio
civila = (rilata al civitanoj) civitana; (interna al komunumo) (inter)civitana, interna; (nearmea) nearmea; (nereligia) nereligia
civilizacio = civilizo 
cunamo = (mara) ondego 
cunamio = (mara) ondego
dabingo = ĉina patkuko
daĉo = (rusa) feridomo
daltonismo = kolorblindeco; ruĝverdblindeco (kiel plej ofte priparolata formo de kolorblindeco en la komuna lingvo)
damo = sinjorino, reĝino (en kart-ludoj)
damaĝi = malutili, difekti
damaskeni = ornami per oro aŭ juveloj, damaskumi
damni = malbeni
dampi = mildigi, sufokigi 
dampilo = fumtubo 
dank' al = danke al; (kiel memstara elkrio la tradicia "dank' al" estas akceptebla, sed ankaŭ uzeblas "dankon al")
darfi = rajti, povi, esti permesita, havi eblon
dariolo = fritita pastopoŝo kun interna dolĉaĵo
datao = informo/-ero, donitaĵo 
dateno = informo/-ero, donitaĵo 
datumo = informo/-ero, donitaĵo 
daŭbo = barela tabulo 
daŭfeno = heredonta reĝido, kronprinco
debila = malforta, senforta
debuti = sin prezenti, komenci, unue aperi (uzata por aktoroj kaj spektakloj)
decembro = la 12a monato
deci- = dekono [rimarko: en la vorto 'decimetro' kaj similaj 'deci' estas parto de unu tuta radiko 'decimetr-' kaj similaj]
decimo = deka intervalo, dekto. Vidu ssv plio 9.
decimala = dekuma
defaŭlta = implicita, norma, antaŭfiksita/agordita, ĉefa (kiam temas pri elekto inter pluraj eblecoj) 
defetisto = malvenkisto, malvenkulo 
definitiva = fina, malprovizora, neŝanĝebla, firme decidita
deflori = malvirgigi
degni = (kompleze/tolere) bonvoli, komplezi, bonvole konsenti 
deismo = diismo, dikredo, kredo je la ekzisto de neinteraganta dio
dekado = (laŭ la kunteksto) tagdeko; jardeko; (en matematiko) dekoblo-intervalo.
dekalogo = dek ordonoj (religiaj)
deklami = laŭtlegi
deklaracio = deklaro
dekokti = bolkuiri, bolsolvi
dekoracio = scenfono, scenaranĝo; ornamo; honorinsigno
dekori = dekoracii (en la teatra senco); ornami (en ĝenerala senco).
delegacio = delegitaro 
delico = plezuro, intensa plezuro
demagogio = demagogeco, demagogemo
demarkacio = limfiksado
demarŝo = esploro, interveno, solvprovo
dementi = malkonfirmi, malpravigi
demisii = eksiĝi, rezigni, eksoficiĝi; deklari eksiĝon
demokrato = demokrati(ism)ano, demokratiulo [demokratio estas en la 8oa]
demonstri = montri, klarigi, pruvi (laŭ la signifo en la unuopaj okazoj)
demonstracio = montrado, pruvado, manifestacio (laŭ la signifo en la unuopaj okazoj)
denco = danco 
dendrologio = arboscienco
dendrokronologo = arboringofakulo
dendrokronologio = arboringostudado 
denove = ree, nove, refoje 
dentalo = denta konsonanto
departemento = (laŭ la administra signifo en Francujo) distrikto, distriktaro
depeŝo = mesaĝo, rapida mesaĝo 
depost = de antaŭ
deprimi = senenergiigi, senkuraĝigi, malvigligi
deputito = parlamentano
dermatologo = haŭtkuracisto, haŭtisto
desaponti = seniluziigi 
desapontiĝi = seniluziiĝi, elreviĝi, disreviĝi
descendi = malsupreniri 
desinfekti = malinfekti, seninfektigi.
desinfektado = malinfektado, seninfetigo
desinfektaĵo = malinfektaĵo, seninfetigaĵo
desinfektilo = malinfektilo, seninfektigilo
desperi = malesperi, senesperi, senesperiĝi 
despoto = tirano
detekti = trovi, malkovri, (en elektroniko) malmoduli
detektoro = malkovrilo (ofte en 'metal-malkovrilo')
devanci = preterpasi, postlasi 
devii = devojiĝi
devizo = fremda mono, fremda ĉeko, fremda valuto
dezajni = fasoni, projekti, aspektigi
dezajno = fasono, aspekto; fasonado, projektado, aspektigado, formkreado
diabeto = sukermalsano
diagramo = grafikaĵo
diakrita = distinga, utila por distingi
diakrita signo = kromsigno, alsigno, supersigno (en Esperanto, kaj en aliaj lingvoj), subsigno, apudsigno, trasigno (en aliaj lingvoj)
diakrona = tratempa
diapozitivo = lumbildo 
diatopa = traloka
dieto = parlamento
didaskalio = klarigo, klariga teksto, priskribo (en foto)
dificila = malfacila
diglosio = lingva duobleco, lingva dunormeco
diĝesto = resumo 
diĝita = cifereca 
dikotoma = dubranĉa
dikotomia = dubranĉa
dikotomio = disdueco, disduiĝo
diktato = trudordono
dilui = malkoncentri
diluvo = superakvo, inundo
dinamiko = fortomovoscienco
diplomato = diplomatiisto
dipsomaniulo = drinkulo, drinkomaniulo
direkcio = direktistaro, estraro, direktoraro, direkta aro 
direktoro = direktisto
dirigento = orĥestrestro 
dirko = ŝtelmalŝlosilo, hokmalŝlosilo 
dirlididi! = ba! , bagatele!
dirta = malpurega 
disdegni = malŝati 
disertacio = disertaĵo
disertacii = diserti
disidento = alipensulo
disipi = malŝpari, forneniigi
disleksio = vortblindeco
diskedo = disketo
diskoo = diskeja muziko 
diskografio = diskoj, diskaro, diskolisto, eldonitaj diskoj
diskordo = malkonkordo, malharmonio 
diskoteko = dancejo, diskejo, diskodancejo; diskokolekto (analoge al 'biblioteko') 
diskrecio = bontrovo
diskrediti = misfamigi, malbonfamigi
diskurso --> parolado, teksto, rezonado
diskursiva = malintuicia
dismo = dekonimposto, dekonaĵo 
disocii = malkombini, disigi
disonanco = misharmonio, misakordo, (muzike) dissoneco, dissonaĵo.
dispensi = liberigi, sendevigi, senŝarĝigi 
dispensario = senpaga kuracejo
dispozicio = (maniero laŭ kiu io estas dismetita) dismeto; (juraj preskriboj aŭ reguloj) normo; (natura emo) emo
dista = malproksima
disteismo = malbondiismo, malicdiismo
distiko = versduo
diurno = tagnokto, tago, 24 horoj
diverĝi = (laŭ la signifo en la konkretaj okazoj) disiri, disiĝi, strebi disiĝi, malsami, malakordi; (matematike) mal-konverĝ-i
divizoro = dividilo, dividanto, dividanta nombro 
divorco = eksgeedziĝo, dividiĝo 
dizajni = fasoni, projekti, aspektigi
dizajno = fasono, aspekto; fasonado, projektado, aspektigado, formkreado
djablo = malalta ĉareto 
docento = universitata instruisto
dojeno = plejaĝulo 
doko = havena baseno
dokta = klera, klerega, sciplena 
doktoro = klerulo
dolo = krimintenco, trompintenco
domajno = retnomo
domeno = retnomo 
domicilo = loĝloko 
dorika = dora
dragono = drako 
draĝeo = sukermigdalo 
drajvo = pelilo
dramaturgio = dramverkado, dramarto
dramaturgo = dramisto, dramverkisto
dresi = malsovaĝigi
drezino = relĉaro
driado = arba nimfo
drilo = borilo
drivi  = libere flosi, devoje flosi
drogmano = interpretisto, buŝtradukisto 
drola = stranga, amuze stranga, amuza, ridinda, ŝercema
droŝko = (lu)kaleŝ(et)o
drumo = tamburaro
dualismo = duismo
dubelo = ŝraŭbbazo, ŝraŭbtenilo, ŝraŭbfirmigilo, enŝraŭbmaterialo 
dubli = voĉtraduki, sontraduki, duoblumi 
dukto = konduktubo; (en kelkaj okazoj, ĉefe en medicino) tubeto 
dueto = (en la senco de du kun-ludantoj aŭ kun-kantantoj) duopo, duo; (en la senco de verko por du) duopaĵo 
dumpingo = subkosta vendado, ŝutvendado
sociala dumpingo = malaltkosta dungado
duno = sablomont(et)o
duonpatrino = vicpatrino
dupo = trompeblulo
dura = malmola
durdisko = malmola disko, fiksita disko
duzo = fluaĵakcela tubo
DVD = lumdiskego
easto = oriento 
ebleco = eblaĵo, eblo (en la okazo de io, kio estas elektebla: vi havas du eblojn, iri tuj aŭ iri morgaŭ)
editoro = redaktant/int/onto
editorialo = ĉefartikolo
edro = faco 
egoismo = memismo, mieco, miismo, memcentreco
egoisto = memisto, miisto, memcentristo, egoismulo
egotismo = memcentreco, egoismo 
egzameno = ekzameno
eĝo = rando, angulrando
eĥografio = eĥobildigo, eĥobildo (la rezulto)
eĥokardiografio = eĥokorbildigo
eĥokardiogramo = eĥokorbildoj
eĥokardiografo = eĥokorbildigilo
ejektivo = (aer)elĵeta konsonanto
ekliptiko = terorbito 
eko- = ekologia
ekonomio (en la senco de ŝparado) = ŝparo, ŝparado. ŝparemo
ekonomiko = ekonomiscienco
ekscesi = troe fari, tro fari 
ekscizi = fortranĉi
ekskludi = ekskluzivi 
ekskuzi = senkulpigi, pardoni 
ekskuzo = senkulpigo, preteksto
senekskuza = nepardoninda, nepravigebla
ekslibriso = libromarko, posedantomarko, posedantoslipo
eksoskeleto = ekstera skeleto
ekspansio = plivastiĝo, plietendiĝo
ekspekti = atendi, antaŭvidi
ekspektori = kraĉi
eksperimenti = sperti 
eksperto = fakulo, spertulo 
ekspertizo = raporto, (valor-)takso
eksplici = malimplici, klare esprimi
eksplicita = malimplicita, klara, klaresprima
ekspliki = klarigi 
eksponi = ekspozicii
ekspozi = ekspozicii
ekspresa = rapida 
ekspresionismo = esprimismo
ekstradicio = transdono (de kriminto)
ekstrakto = eltiraĵo
ekstraktadi = eligi, eltiri
ekstravaganco = nekomuna strangaĵo, kondutstrangeco
ekumena = Evitinda pro tro multaj signifoj! Jen kelkaj el ili, laŭ la kunteksto: tutmonda, tutkatolika, tutortodoksa, tutkristana, tutreligia, ĉiureligia, interreligia, religiunuiĝa, universala, ĝenerala
ekumenismo = Vidu indikon ĉe "ekumena". Lau la kunteksto: tutkristanismo, interreligiismo, religiunuiĝismo
ekumeno = Vidu indikon ĉe "ekumena". Lau la kunteksto: tuta mondo, mondo
ekvalizi = egaligi 
ekvilibro = egalpezo, sampezo 
ekvinokso = tagnoktegaleco
ekvivalenta = samvalora, egalvalora 
ekzakta = preciza
ekzegezo = klarigo, interpreto
ekzalti = entuziasmigi, trovigligi
ekzekuta (por direktoro, komitato) = plenuma
ekzotera = publika, publike instruata
elano = impulso, impeto
elo = angla biero
elektrokardiografo = elektrokorbataparato, elektrokorstriaparato, elektrokorspurilo, elektrokorregistrilo
elektrokardiogramo = elektrokorbatlinio, elektokorstrio, elektrokorspuro, elektrokorregistraĵo
elektronika (krom en okazoj kiam ĝi signifas: funkcianta per elektraj signaloj aŭ iel rilata al elektroniko) = (laŭ la kunteksto) elektrona, elektronscienca, komputila
elimini = forigi
elipso = vortoellaso
elvokiva = elvoka, elvokpova
emajlo (en komputil-retaj aferoj) = retmesaĝo
emancipi = liberigi
embargi = malpermesi (foriri, komerci, ktp.)
embrazuro = fenestreto, paffenestreto
emerituro = pensio 
emigri = elmigri 
emigracio = enmigrintaro, enmigrinta komunumo, enmigrado
empatio = kunsent(ad)o, sentokompreno
empiro = imperia stilo 
empireŭmo = brulodoro
encefalo = cerbo
encikliko = papa rondletero
endemio = loka malsano, loka ripeta malsano
endemia = loka, regiona
endokrina = hormona, hormonellasa
endokrinologo = hormonsciencisto; hormonkuracisto
endokrinologio = hormonscienco
endoskeleto = interna skeleto, ena skeleto
engaĝi = dungi 
englo = anglo
engraŭlo = sardelo
enjekcio = disĵeto, unualunufunkcio
enologo = vinfakulo, vinsciencisto
enorma = grandega, nenorme granda 
ensemblo = muzikgrupo 
entalpio = varmoenhavo, energienhavo
entjero = plena nombro
ento = ekzistaĵo 
entomologio = insektoscienco
entreo = antaŭmanĝo
enumeracio = listigo
eosto = oriento
epicentro = surfaca centro
epidemio = amasinfekta malsano
epigrafo = surskribaĵo 
epika = epopea
epistakso = nazosangado
epistemologio = sciteorio, fiolozofio de scienco
epitafo = tomboskribo, surtomba frazo
epitalamo = geedziĝa kanto
epiteto = adjektivaĵo, ecovortaĵo
epitomo = resumo, resuma lernolibro, eltiraĵo 
eposo = epopeo
erco = mineralo, minaĵo 
erekcio = erektiĝo
eritrocito = ruĝa sangoĉelo
eritroforo = ruĝpigmentĉelo, ruĝpigmentoĉelo, ruĝpigmenta ĉelo
erota = erotika 
erudi = klerigi
erudicio = (profunda kaj diversfaka) klereco
erudiciulo = klerulo
esameno = abelsvarmo, abelaro 
-esk- = -ec-
eskalo = ŝtupetaro; (ŝiraĵo kun formo de ŝtupetaro en maŝŝtofo) dismaŝiĝo, maŝofalo 
eskaladi = grimpi
eskalatoro = rulŝtuparo
eskarpeno = dancoŝuo 
eskulo = ĉevalkaŝtanujo
eskvizita = rafinita, ege bonkvalita, bongustega, rava 
esoterika = esotera
Esperantio = Esperantujo
esperantofono = esperantoparolanto 
esperantologo = Esperanto-fakulo, Esperanto-sciencisto, esperantologiisto
esperantologio = Esperanto-scienco
establo = organizaĵo
estiel = kiel 
estetiko = belecstudo, belecscienco
estrado = podi-o 
eŝafodo = mortigpodio
etalono = normaĵo, kompara indiko
etato = listo, tabelo 
etimo = fontvorto, pravorto, originvorto, vortfonto 
etimologo = vortdevensciencisto, vortdevenfakulo, vorthistoriisto
etimologio = vortdevenscienco, vorthistorio, vortdeveno, deveno (de vorto), vortfonto
etiologio = kaŭzoscienco, kaŭzostudo (precipe pri malsanoj)
etnografo = etnografiisto, etnosciencisto, gentoersploranto
etnografio = etnoscienco, popolpriskribo, gentoesploro
etnologio = etnoscienco
etnologo = etnosciencisto
etologio = kondutoscienco
eŭfemismo = plibeliga ĉirkaŭdiro, evitesprimo, ĉirkaŭparolo, ĉirkaŭskribo, bonvorto, pura lingvaĵo, 
eŭfonie = belsone 
eŭforio = ĝojosento, bonfartosento
eŭkaristio = eŭĥaristio
eŭro- = eŭrop-
eŭteismo = bondiismo
evento = okazaĵo 
evolucio = evolu-o 
-eza = -a
fado = faduo
facio = vizaĝo, (ĉe bestoj) muzelo; (en medicino ankaŭ) aspekto
fajlo = dosiero, dokumento 
fajna = subtila, delikata
fajnajta = limhava, limigita, finhava 
faksimilo = kopio 
fakultato = fakaro (en universitato)
fakultativa = libervola, nedeviga
falafelo = kikerbulo. Vidu ssv plio 12.
falsa = (en la senco 'falsita') falsita, (en la senco 'malvera') malvera, neaŭtenta
falto = (en komunuza senco, parolante pri haŭto) sulko, sulketo, haŭtsulko
falva = helflavfela 
familiara = neformala, malformala, senceremonia, senĝena
fano = subtenanto, favoranto, fanatikulo, fervorulo, entuziasmulo, zeloto, adepto; (en la signifo de rizaĵo laŭ la uzo de ĉinaj esperantistoj) rizaĵo
fanagalo = la fanagala (lingvo)
fanfaroni = (mensoge) tro igi 
fanto = paĝio, knabo, bubo, soldato
far = fare de
farmacio = apoteko, apotekofako/scienco 
farmakologio = kuraciloscienco
farniento = nenifarado 
fasado = fronto, antaŭa parto, vizaĝo 
fascini = ravi, sorĉi, ĉarmegi, interesegi, allogegi. Vidu Ssv plio fascini.
fatamorgano = miraĝo
fatraso = aĉaĵaro, forĵetindaĵo, neutilaĵo
faŭno = bestaro
favelo = (mizera) ladkvartalo, (mizera) kvartalaĉo
febla = malforta
februaro = la 2a monato 
federacio = federaĵo
federala = federa
femala = in(seks)-a
femalo = ino, virino
femina = ina, virina 
feminismo = inismo, virinismo
feministo = inisto, virinisto
femuralo = femurosto 
feroca = kruelega, sovaĝe kruela
fetoro = fiodoro, odoraĉo, malbonodoro
fiakro = lukaleŝo, luveturilo
fiasko = malsukceso 
fiĉo = ludmarko
fiki = seksumi
fiksa = senmova
fiktiva = fikcia 
filandro = aranea fadeno
filantropia = homama
filatelo = poŝtmarkkolektado
filatelio = poŝtmarkkolektado 
filio = branĉoficejo/kompanio 
filmoteko = filmarĥivejo
filologo = filologiisto, lingvosciencisto
filologio = tekstoscienco, lingvoscienco, scienco pri lingvoj, historio de lingvoj (la senco varias laŭ la landoj)
financo = mon/spez situacio/regado 
finia = finhava 
finio = finhava nombro / punkto / kvanto
finiŝo = finstreĉo, fina peno, fina impeto
Finnlando = Finlando, Suomujo
finno = finlandano, suomo
finsemajno = semajnfino
-fila = -ema (ekzemplo: ruso-fil-a -> rus-em-a)
firmo = firmao. Vidu fun: firm-o.
firmamento = ĉiela volbo, ĉielo
firsto = pinto
fitneso = (korpa) bonfarto, trejniteco; (korpo)trejnado, gimnastiko
fitnesejo = (korpo)trejnejo, gimnastikejo
fitoterapio = vegetaĵkuracado
fizika = (en la senco 'materia' aŭ 'korpa') materia, korpa
fizioterapio = fizikkuracado, pergimnastikkuracado
flagrilo = sparkobastoneto
flartabako = naztabako
flaŭro = vegetaĵaro, plantaro; (en la senco de mikroboj en la korpo) mikrobaro
fleŝo = karno
floto = ŝiparo
fluida = fluaĵa
fluidaĵo = fluaĵo
fluido = fluaĵo
fluso = alfluo
flutero = rapida atripulsado, korflirtado
fokolaro = fajrujo (en ĉiuj sencoj)
fola = frenez-(et)-a 
fonduso = fondaĵo 
-fono = -parolanto (ekzemplo: esperanto-fon-o = esperanto-parol-ant-o)
fonemo = (distingopova aŭ signifa) parolsono, sontipo, sonunuo 
fonem()iko = scienco pri parolsonoj, fonemscienco 
fonetiko = parolsonscienco, elparola scienco, prononcoscienco
fonio = sona komunik(ad)o
fonografo = cilindroturnilo
fonologio = fonemscienco, scienco pri parolsonoj, fonemscienco, parolsona sistemo (de lingvo)
forci = kultivi en kultivdomo
forcejo = kultivdomo
forceja efiko = kultivdoma efiko
formato = form-o, inform-aranĝ-o
formiato = salo de formika acido
formikao = glimpasto
fornelo = kuirilo, kuiraparato, kuirforno 
forsto = (kultiv)arbaro
forstista = (kultiv)arbarista 
fortreso = fortikaĵo
foruo = tradicia leĝo, loka leĝaro (ĉefe en Hispanujo)
forvardi = plusendi
fotelo = brakseĝo 
fotogena = fotinda, fotografinda
fotopletismografio = perluma sangokvantomezurado
fotri = seksumi; (en aliaj kuntekstoj) tedaĉi; difekti. 
fragila = rompiĝema, malforta, facile rompebla 
framo = kadro, kadreca trabaro
franĉizo = (en asekuroj) propra risko, neasekurita parto, mempagenda parto; (en komerco) ludonado/prenado de komerca nomo
frankofono = franclingvano
fratrio = (greka) familiaro, klano
fraŭdi = trompŝteli, falsi
frazeologio = frazaro, frazaranĝo, (en la senco de "proverbaro") proverbaro (Ni ne malrekomendas la uzon de la vorto en la senco de "scienco de kutimaj vortaranĝoj")
frekvenco = vibronombro (en fiziko), ofteco, ofto (en la ĝenerala lingvo kaj en statistika lingvo)
frekventi = vizitadi
frida = malvarma, (metafore:) senemocia
fri = afranke al, inkluzive (kostojn por/ĝis) 
fridkamiono = frostkamiono, frostujkamiono, glacikamiono, malvarmkamiono
fridujo = malvarmujo, malvarmŝranko
frikativo = frota sono, frota konsonanto
frikulo = esceptulo, devojiĝulo, maldando
fripono = trompisto, trompanto
frisbio = ŝvebdisko 
friska = malvarmeta, agrable malvarma 
fristiko = matenmanĝo
fritoj = terpomfingroj, frititaj terpomoj
froko = monaĥa robo
frondo = branĉeto
frontala = frunta, antaŭa
ftiro = pubopediko 
ftizo = tuberkulozo
ftiziatrio = ftizokuracado, ftizoesplorado
fuelo = brulaĵo (por motoroj), brulmaterialo, energifonto
fuero = tradicia leĝo, loka leĝaro (ĉefe en Hispanujo)
funelo = enverŝilo
furgono = ŝarĝveturilo, kamioneto 
futbalo = piedpilkado, asocia piedpilkado
futsalo = halopiedpilkado, salonpiedpilko
futuro = ostempo, estonta tempo
futo = piedlongo
fuzelaĝo = korpo (de aviadilo)
gaĝo = garantiaĵo 
gaki = ansere bleki, ansere kanti 
galimatio = misparolo
gallo = gaŭlo 
gamo = tonaro, toneraro 
gambo = kruro
gapi = mire rigardi, rigardi kun malfermita buŝo, senkomprene rigardi
gasojlo = dizeloleo, dizelpetrolo, (NE uzu en la senco de 'benzino')
gasolino = benzino
gasometro = gasorezervujo; (en la senco de gas-mezurilo) gasmezurilo
gastro = stomako
gastropodo = ventropiedulo
gatjo = virkalsoneto aŭ tipa vilaĝana gambingo
gaŭĉo = (sudamerika) rajdpaŝtisto, (sudamerika rajdanta) bovisto/bovgardisto
gaŭĝo = sondilo, mezurilo
gazolino = benzino
gazono = herbotapiŝo, herbetejo, herbobedo, belherbejo, razeno. Vidu Ssv plio 6.
gejo = samseksemulo
gelo = frosto 
gemuta = agrabla, hejmeca
generalisimo = ĉefgeneralo 
generatoro = (elektro)generilo
genetika = gena
genocido = popolmurdo, gentomurdado
genomo = genaro
genro = (seksbazita / animecbazita) (substantiv/vort)klaso, (gramatika) sekso. Vidu ssv plio 13.
genro = specaro
genro = (socia) sekso, (socia) seksrologento
geo- = tero, mondo, tutmonda
geocentra = tercentra
geodezio = termezurado, mondomezurado
geografo = geografiisto
geokaŝado = tutmonda kaŝado
geokaŝanto = tutmonda kaŝanto
geologo = tersciencisto, geologiisto
geologio = terscienco, grundscienco, grundstudo, scienco pri ternaturo/kvalito 
geometro = geometriisto, termezuristo, kampomezuristo, konstruteĥnikisto
geometrio = formoscienco, mezurscienco
geriatrio = maljunulmedicino, maljunmedicino
geriatro = maljunulkuracisto, maljunkuracisto; maljunulmedicinisto
gerontologio = maljunecoscienco
getto = geto, juda kvartalo
ghetto = geto, juda kvartalo
giga- = miliardo
giganto = grandegulo
Gigeso = Gigo (reĝo en la greka mitologio, kiu havis ringon, kiu igis la posedanton nevidebla)
giko = studemulo, (komput/teĥnik)fantatikulo/maniulo/obsedato, kodumulo
gimnazio = meza lernejo, mezlernejo, supera mezlernejo
ginekologo = virinkuracisto, porvirinaa kuracisto, porina kuracisto, kuracisto de virinoj 
gingivalo = gingiva konsonanto
gingiv-o = dentokarno
giri = turniĝi 
gjako = poefago = gruntbovo, tibeta bovo 
glaco = spegulvitro 
glacoviŝilo = vitroviŝilo
glacea = brilpolurita
glaĉero = glacirivero, (en la ĝenerala lingvo) glaciejo
glatiso = glacio, glacitavolo 
glebo = terbulo 
glisi = flugŝvebi 
globala = tutmonda
globaliĝo = tutmondiĝo, tutmondigo
globalizo = tutmondiĝo, tutmondigo
globulo = sangoĉelo
globuso = terglobo, terglobeto 
glupo = stultulo
gluteo = sidvango 
gofri = brulstampi 
goldeno = ora, bongusta/flava, bongusta pomo (se oni nepre volas asimili tiun nomon per tradukado)
goŝisto = maldekstrulo 
gracila = malforta, maldikega
graf- = skrib-, priskrib-
grafitio = murskribaĵo, murpentraĵo, pentroskribaĵo
grafologo = skribesploranto
grafologio = skribesploro
grafomano = skribmaniulo, skribemulo
grafomanio = skribmanio, skribemo 
graki = (korve) bleki/kanti 
gramofono = diskoturnilo 
granolo = (malgranda) pilolo, grajneto
granulo = (malgranda) pilolo, grajneto
grateni = krustbaki, krustige baki, krustumi
gratenita = kun (fromaĝa / panera) krusto, krustbakita
gratenaĵo = krustbakaĵo
graŭ = danke al
grefo = ungego 
grejso = sabloŝtono, sabloŝtonaĵo 
greso = herbo, paŝtherbo 
grimpoframo = grimpostangoj 
grioto = acida ĉerizo 
grivo = lardopeceto, lardorostaĵo 
groba = nerafinita, granda
groco = dekduo da dekduoj, 144 
grondi = grundi (pri ŝipo, kiu restas implikita en la malalta fundo de maro aŭ rivero) 
gropo = (besta) dorso
grumo = servist(et)o
grumbli = murmur(eg)i
grundologio = grundoscienco, grundostudo
grundologo = grundosciencisto, grundostudanto
grunti = (porke-)bleki
gubernatoro = provincestro, registo 
gubernio = provinco
guberniestro (parolante pri Usono) = subŝtatestro
gufujo = (nokta) tetrinkejo (en junularaj renkontiĝoj). Vidu esp: gufujo.
gugli = retserĉi
guno = junbovino
gurdo = turnorgeneto 
gvardio = gardistaro
gvardiano = gardisto
gvati = kaŝe observi
gvidoro = gvidanto, gvidisto
ĝaino = ĝajno
ĝelo = gelateno
ĝemelo = dunaskito
ĝemela urbo = amika urbo, partnera urbo
ĝemina = duopa
ĝenio = feo, koboldo
ĝentlemano = noblulo, kavaliro, ĝentilulo
ĝermo = malsaniga mikrobo
ĝino = feo, koboldo
ĝinso = ĝinzo
ĝisosta = forte konvinkita; (pri Esperanto) obstina esperantisto
ĝisostulo = Vidu ĝisosta.
habiliti = rajtigi, kapabligi
haĉi = streketumi
halanĝo= ŝercgalimatio, sensenca parolado
haleluja = laŭdon al dio!, vivu!
halfo = centrulo, ŝirmanto, defendanto
ha lo! = saluton!, hola!
halo! = saluton!, hola!
halukso = pieda dikfingro 
hamburgero = hamburgaĵo
handbalo = manpilkado 
handikapo = egaliga (mal)avantaĝo; (ĝenerale) malavantaĝo, nekapablo, difekto, invalideco
handikapulo (pri homo kun malavantaĝoj) = malavantaĝulo, nekapablulo, difektito, invalido
hanti = vizitadi (fare de fantomoj), obsedi
hardi = malmoligi 
hardvaro = aparataro
harmonizi = harmoniigi, aldoni harmoniajn voĉojn
hasti = rapidi
hati = malami 
haŭli = ŝnurtiri 
haŭsiero = kurzaltiĝa spekulanto
haŭzo = dommuziko 
heĝo = arbusta barilo, (ĉirkaŭ)barilo, (plekto)barilo
hej = saluton!
hejmpaĝo = (en la senco de 'kolekto de retpaĝoj ĉe unu TTT-adreso/servilo') retpaĝaro, retejo (en la senco de 'ĉefa/komenca paĝo de retpaĝaro') ĉefpaĝo, enirpaĝo
hekatombo = buĉofero; amasmortigo, amasbuĉado
hekt- = cento da 
hekto- = cento da 
hektika = febra, febre varianta
hektografo = (malnova) multobligilo
helianto = sunfloro
heliocentrismo = sunocentrismo
hemat- = sang-
hematemezo = sangovomado 
hemi- = duon-
hemisfero = duonsfero, duonglobo
hematio = ruĝa sangoĉelo
hemoragio = sangado
heni = (ĉevale) bleki
heno = mal-am-o
henoteismo = unudiismo kun aliaj dioj, unudiadoro kun akcepto de la ekzisto de aliaj dioj
hepatiko = hepata herbo
hepatito = hepatinflamo 
heraldiko = blazonfako
herdo = grego, cervaro, ktp... 
hermeta = netralasa, perfekte fermita
hermetika = netralasa, perfekte fermita
heterogena = malsam-(natur-)a
hiato = (en gramatiko) vokaldiseco; (en aliaj fakoj laŭ la kunteksto) fendo, breĉo, paŭzo, interrompo, intervalo, malfermaĵo 
hibrida = miksita
hibrido = durasulo, miksrasulo
hibriso = troa memfido
hieroglifo = egipta skribsigno
hida = malbelega 
hidranto = premakvotubo
hidro- = akvo- 
hidrodinamiko = fluscienco
hidrogeologio = grundakva scienco
hidrologo = akvosciencisto
hidrologio = akvoscienco, akvostudo
hidroplano = maraviadilo
hidrostatiko = scienco pri nemoviĝantaj fluaĵoj
hidroterapio = akvokuracado
higrometro = malsekecomezurilo
hiko = malfacilaĵo 
Hindujo = Barato
hinĝo = pordhoko 
hiper- = super-
hiperbolo = troigo
hipertensio = alta sangopremo
hipertermio = supera (korpo-)temperaturo, alta (korpo-)varmo
hipo- = sub
hipocentro = subtera centro
hipokastano = (por la arbo) (komuna) ĉevalkaŝtanujo; (por la frukto) (komuna) ĉevalkaŝtano
hipokaŝtano = (por la arbo) (komuna) ĉevalkaŝtanujo; (por la frukto) (komuna) ĉevalkaŝtano
hipokondrio = imagata malsano, ŝajnmalsano
hipotensio = malalta sangopremo
hipotermio = malsupera (korpo-)temperaturo, malalta (korpo-)varmo
hipotenuzo = longa latero, kontraŭorta latero,
hisi = levi, suprentiri
hobalo = mirho 
hobio = ŝatokupo 
hodogo = kolbasbulko
hodometro = paŝmezurilo
hola = saluton! 
holdo = (funda) ŝipinterno 
holdingo = tegmenta firmao
holmo = monteto 
holonimo = vorto por la tuto, tutovorto
homeopato = homeopatia kuracisto, homeopatiisto
homo- = sam-
homofobio = kontraŭsamseksemo, kontraŭgejeco
homofono = samsonvorto
homogena = sameca, egalkvalita 
homografo = samskribvorto
homologa = sama, simila 
homonimo = samforma vorto, plursignifa vorto
hop! = bone!, bele! (diritaj por substreki sukcese faratan aŭ faritan faron, kiel en la proverbo "ne diru hop! antaŭ la salto.")
hordo = nomada tribo, invadantaro, bandaĉo
hororo = (laŭ la kunteksto kaj la intencata signifo oni povas uzi unu el ĉi tiuj vortoj aŭ kombinon de ili) timego, teruro, abomeno
horoskopo = stelaŭgurilo, steldiveno, astrodiveno 
hortikulturo = plantkultivado, plantkultiva scienco, ĝarden(kultiv)ado
horto = fruktoĝardeno
horzonozo = horzona konfuzo, horzona laco, horzonsufero, sufero pro hordiferenco, problemo pro hordiferenco, konfuzo pro horzondiferenco, tempoŝanĝo, horoŝanĝo
hosana = savu nin!, vivu! gloron!
hoso = mola tubo
hospitalo = malsanulejo 
hotdogo = kolbasbulko
humana = homa, homeca, homama (laŭ la senco) 
humaneco = homeco, homamo 
humanitara = homa, homama, homhelpa, homcela (en esprimoj kiel 'homcela helpo'), homrilata (en esprimoj kiel 'homa/homrilata katastrofo')
humida = malseketa; (parolante pri aero) malseka
humoro = animstato
humuro = ŝercemo, ŝerco, sprito 
humuso = kikerkaĉo
hupi = (avert)soni/igi 
hurli = (lupe, laŭte) bleki, krii
hurti = albatiĝegi
ĥiroptero = vesperto
ĥirurgio = kuracado per operacio
-i- = -uj-, -land- (por land-nomoj), -scienc- (por sciencoj)
I = 1, 1a 
II = 2, 2a 
III = 3, 3a 
IV = 4, 4a 
IX = 9, 9a 
-icido = -mortigaĵo, mortigilo
-iĉ- = vir-, vira 
ideografio = idesignoskribo, vort(er)signoskribo
ideogramo = ideosigno; vort(er)osigno
ideologio = idearo, ideosistemo, ismo
idiolekto = persona lingvo
idiosinkrazio = (laŭ PIV, en psiĥologio) individua sinteno, individua trajto; (en medicino) individua reago, nenormala reago; (en lingvoscienco) individua esprimmaniero, unuopula parolmaniero; (eraraj uzoj laŭ aliaj lingvoj) persona strangaĵo (anglece); troreagemo (italece)
idiomaĵo = lingvoapartaĵo
idiotismo = lingvoapartaĵo
iglo = neĝodomo
iĥtiofagio = fiŝomanĝado
iĥtiologo = fiŝosciencisto
iĥtiologio = fiŝoscienco
iĥtiokolo = fiŝgluo
-ik- = -scienc-, -fak-, -art-
ikonoklasto = (religia) bildorompanto
iktero = flaviĝo, flavmalsano, flaviĝmalsano
ilegala = kontraŭleĝa, eksterleĝa 
ilio = intestosto
iliumo = intestosto
iljo = intestosto
imagino = finstadia insekto
imaginaro = imaga nombro
imbecilo = stultulo
impakto = kolizio, bato; efiko (laŭ la kuntekstoj)
imperativo = ordona modo
imperialo = surtegmentaj sidlokoj
imperialismo = imperiismo
imperialisto = imperiisto
impertinenta = malrespekta 
implementi = efektivigi, plenumi
implici = enhavi, subkomprenigi, kuntreni
imploziva = maleksploda (konsonanto)
importi = enporti
impresionismo = impresismo
impresionisto = impresisto
imprimaturo = prespermeso
inamika = malamika 
inanicio = nutraĵomanko 
imaŭguracio = malfermi, komenci, inaŭgurado 
inaŭguri = malfermi, komenci 
incendio = brulo, dombrulo, brulego
incesto = (en-)familia seksumado, (en-)familia malĉastaĵo
incidento = okazaĵo
incizivo = tranĉodento
indikativo = ĝenerala modo, indika modo, montra modo
indiano = indiĝena usonano, indiĝena kanadano, indiĝena meksikano, indiĝena nordamerikano (laŭ la priparolata situacio)
indico = karakterizaĵo 
indiĝeno = praloĝanto 
individualismo = individuismo
inercio = inerto , inerteco, neŝanĝemo, malvigleco
infarkto = koratako 
infinita = senfina
infinito = senfineco
infinitezimo = senfinecono
inflamo = brulumo
infloresko = floraro, floretaro, samtiga floraro 
influenco = gripo
informacio = informokvanto, informvaloro, informo
informadiko = komputado, komputoscienco
informatiko = komputado, komputoscienco
infra = sub 
infre = malsupre
infraruĝa = transruĝa
infrastrukturo = baza strukturo, bazaj servoj, bazaj instalaĵoj
infre = malsupre 
inĝenia = eltrovema
inĝenierio = inĝenierarto, inĝenierado
inhibi = malhelpi
inici = enkonduki (en sekton, misteron, kaj similajn)
inicialo = komenclitero 
iniciativo = (laŭ la kunteksto) iniciato, iniciatemo
iniciatoro = iniciatinto
inimika = malamika
inkandeski = (blank)ardi, lumvarmegi
inklinacio = klinangulo
inkludi = inkluzivi 
inkudo = ambososto
inkubatoro = kovilo
inkvizitoro = inkviziciisto
inocento = senkulpulo 
inovacio = novigo
inserti = grefti
insolacio = sunfrapo, sunbato
instepo = piedsupro, pieddorso
instanco = (en la senco de unua, dua, lasta juĝ-grado) juĝgrado
insurekcio = ekribelo
insurgento = ekribelanto
interezo = rentumo
interjekcio = ekkrio
internacia = tutmonda, interŝtata, interlanda, intergenta, plurŝtata, plurlanda, plurgenta
interogativo = demanda vorto
interogacio = parlamenta demando
intra- = en-, interna
inundi = super-akv-i , sub-akv-ig-i
inverti = inversigi
investi = (solene) enoficigi
invoki = alvoki (kiel atestanto)
-io = -ujo, lando
iredenta = ne liberigita, nereunuigita 
iredentismo = reunuiĝismo
iridoforo = irizpigmentĉelo, irizpigmentoĉelo, irizpigmenta ĉelo
iriti = ĝeni, kolerigi
iskio = isĥio, sidosto
iskiato = isĥia/sidosta nervo
iskiatalgio = isĥia/sidosta nervodoloro
iskiatiko = isĥia/sidosta nervo, isĥia/sidosta nervodoloro (laŭ la kunteskto)
-istan- = -land-, -uj-.
iŝi = ili, nurinaj ili
-istik- = -scienc-, -fak-, -art-
-it- = inflamo
itemo = punkto
itinero = vojo, vojaĝo, vojplano, vojaĝplano
-iv- = -pov-, -em-, aŭ nenio, se la radiko estas agkaraktera. Vidu Ssv plio 19 
ivi = vi ĉiuj
-iz- = -ig-, provizi per. Vidu Ssv plio 19 
izo- = sama, egala
jakto = jaĥto
januaro = la 1a monato 
jeno = eno
jeto = reagaviadilo
jetsocieto = pintuloj, ŝajnelito, lastmoda/rapidfluga riĉularo
jetularo = pintuloj, ŝajnelito, lastmoda/rapidfluga riĉularo
jido = la jida (lingvo)
joviala = gajema
jubili = ĝojegi
judo = hebreo
judaismo = = judismo
judezmo = la judezma lingvo
jufto = rusa ledo
julio = la 7a monato
junio = la 6a monato 
junto = kunig(aĵ)o, interfiks(aĵ)o
junti = kunigi, interfiksi
jupano = bienestro
jurisprudenco = juroscienco; juro (validaj leĝoj); juĝistaj decidkolekto
justico = (en la senco de justeco) justeco, (en la senco de ŝtata juĝ-funkcio) juĝinstanco, juĝistaro, juĝministro
ĵaluzio = fenestrokrado, fenestroŝirmilo, fenestrokovrilo
ĵerzo = trikita ŝtofo, trikŝtofo; (kiel lana vesto) = pulovero
ĵetono = (en ludoj) ludmarko, en aliaj okazoj) monmarko, disketo
ĵigo = kunmetenigmo
ĵingoismo = (japana) militemo, militnecesismo, militinsistismo
ĵinso = ĝinzo
ĵurio = ĵuĝantaro
ĵurnalo = gazeto; taggazeto; revuo; taglibro
kabineto = (kiel labor-ĉambro de profesiuloj) laborĉambro, studĉambro; (kiel ekspoziciejo) ekspoziciejo; (kiel ministraro) ministraro, ministra konsilantaro.
kaco = peniso
kaĉaloto = ambrobaleno
kadeto = lernantoficiro 
kadro = funkciulo, gvidanto, direktanto
kafeterio = (memserva) manĝejo
kaĥekta = malsane maldik-(eg)-a, (malsane) malforta, maldika kaj malforta
kaĥeksio = malsaneca maldikiĝo, (malsaneca) malforteco, maldikeco kaj malforteco
kaĵoli = elflati, (pri)dorloti, ĉirkaŭflati, flatumi 
kakofonio = misharmonio, malbelsonaĵ/eco, sonaĉo
kakotrofio = misnutrado
kalcitri = kontraŭstar-(eg-)i
kalifo = ĥalifo
kalkeo = tradukprunto, paŭso
kalkuluso = (organikdevena) ŝtoneto (en la korpo), korpoŝtono 
kalmo = mara trankvilo 
kalorimetro = varmomezurilo
kalorimetrio = varmomezurado
kalumeto = pacpipo
kamerao = filmilo, fotilo; (por la senluma kesteto en tia ilo) kamero
kampuso = universitata tereno
kando = bombono, dolĉaĵo
kanelo = sulketo de disko 
kanistro = ferskatolo, ladskatolo, fera ujo, benzinujo 
kanoniero = pafilegŝipo
kanonigi = deklari sankta, sanktuligi, sanktigi
kanonizi = deklari sankta, sanktuligi, sanktigi
kanono = pafilego, ĉenkanto, rada kanto
kanpo = ĉina medicino
kantino = (laborista) manĝejo
kantono = distrikto
kantrio = kamparana muziko
kanzono = kant-o, kant-et-o, kant-aĵ-o
kapilaro = hardika tubeto
kapodastro = ton'sanĝilo, tonaltigilo
kapsulo = pilolo
kaputa = rompita, difektita
kara = multekosta
karaktraro = signaro, litertipo (komputado)
karaktro = signo, skribsigno, preslitero 
kardi- = kor-
kardino = pordohoko 
kardinalo = (en matematiko) kvantonombro; (en lingvoscienco) kvanta nombrovorto, baza nombrovorto
kardinala = (pri vokaloj/konsonantoj) baza; (ĝenerale pri ventoj, principoj, virtoj, ktp.) ĉefa, baza, fundamenta
kardiografo = korbataparato, korstriaparato, korspurilo, korregistrilo
kardiogramo = korbatlinio, korstrio, korspuro, korregistraĵo
kardiologio = kormedicino, korkuracado, korscienco, korstudo, korfako
kardiologo = korkuracisto, korfakulo, koristo
kardiopatio = kormalsano
karenco = manko, malhavo, malsufiĉo; forpermeso (laŭ la signifo de la germana Karenz)
kargo = ŝarĝo (de varoj), transportataj varoj
karoo = rombo, kvadrato 
kartografo = mapisto
kartografio = mapscienco, mapfarado
kartuno = (se temas pri filmo) desegnofilmo, bildfilmo, desegnita filmo, (se temas pri unuopa desegnaĵo) bildŝerco, ŝercbildo
kasacii = leĝe nuligi
kaseto = kasedo
kastaneo = kaŝtanujo
kastrumo = roma tendaro 
kasuleto = franca fazeolaĵo
kaŝmiro = kaŝmira lano
kataklismo = katastrofo, katastrofego 
katguto = ĥirurgia fadeno 
kateto = orta latero, ĉeorta latero
kaŭ = kaj aŭ
kaŭstika = histodetrua, morda, brulvunda
kazo = okazo (en la senco de okazaĵo), problemo (en la senco de, ekzemple, konscienc-problemo), (juĝ-)afero (en jura senco), aparta malsano (en medicina senco) 
kazuo = konsciencokazo 
KD = lumdisko
kekso = biskvito, kuketo 
kemio = ĥemio 
kep = kiel eble plej
kepre = kiel eble plej rapide
kero = koro 
kestrelo = turfalko
kiber- = reta, interreta, komputila
kidnapi = forrabi
kiki = piedbati (pilkon aŭ simile en pilkaj k.s. ludoj)
kilo = funda ŝiptrabo 
kilo- = mil
kinematiko = movoscienco
kineta energio = movenergio, moviĝeca energio
kirko = (kristana) preĝejo 
kiroptero = vesperto
kirurgio = ĥirurgio = kuracado per operacio
kivo = kivifrukto 
klami = krii, aklami
klandestina = kaŝa, eksterleĝa
klaroskuro = lumkontrasto 
klasifiki= klasi
klaŭno = amuzisto, ridigisto, pajaco 
kleo = muzika ŝlosilo
klefo = muzika ŝlosilo 
kleptomano = ŝtelmaniulo
kleriko = pastro, ekleziulo
klifo = (marborda) rokmuro
kliki = klaki, alklaki
kliko = grupo, (en multaj okazoj) bando, grupaĉo, figrupo; (en la senco de unudirekta meĥanika blokilo) klinko
klimatizi = aerreguligi, malhejti
klimatizilo = aerreguligilo, malhejtilo
klimatologio = klimatoscienco
klipo = (film)peceto, filmeto, muzikfilm-(et)-o
klozeto = necesejo; necesseĝo, neceseja seĝo
kluki = (kukole) bleki/kanti 
knajpo = (germaneca) trinkejo. Vidu esp: knajpo. 
knedlo = pastobulo
knedliko = pastobulo
knelo = fiŝ/viandbuleto 
koĉero = kaleŝisto, luveturigisto
KoDo = lumdisko
kofrujo = pakaĵujo 
kogna = mensa, kona
kogna scienco = mensoscienco
koiti = seksumi
kojlo = dika intesto 
kojono = testiko
kokeriki = (koke) bleki, kokbleki 
kokodrili = paroli gepatralingve (inter esp-istoj)
kokri = (amrilate/sekse) malfideli/trompi/perfidi
koktajlo = koktelo
kolaciono = matenmanĝo, posttagmeza manĝeto
kolaĝo = (bilda/muzika) kungluaĵo
kolaziono = matenmanĝo, posttagmeza manĝeto
kolecisto = galveziko, galujo
koledoko = galdukto, galfluejo
kolegio (en la franca lerneja sistemo) = (unua) mezgrada lernejo
kolekcio = kolekto, kolektaĵo
koliero = kolringo, kolĉeno 
koloro (en kart-ludoj) = emblemo
koltro = plugila vertikala tranĉopeco, plugilsteveno 
kolumno = kolono, eseo, koloneseo, esekolono 
komasacio = terpeckunigo
komentarii = komenti
komikso = bildrakonto, bildŝerco 
komisiono = komisiitaro
komitativo = kuneckazo
(cerba) komocio = (cerbo)skuo/skuiĝo/ŝok(eg)o
kompakta disko = lumdisko
kompano = kamarado, kunulo, kunvivulo, samlaborulo
komparacio = (lingva) komparado [??] 
komplementa (en senco ne-gramatika) = kompletiga
komplico = kunkrimanto
komplika = malsimpla, malfacila, komplikita (Normale 'komplika' signifas "rilata al 'komplikado'.) 1oa: komplik-i
komponisto = muzikverkisto 
komponi = muzik verki 
kompoŝto = (maturiĝanta) humigataĵo, (maturiĝinta) humigitaĵo
kompromiso = sindevigo, devo
kompromiti = sin devigi
kompunda = kunigita, duparta, plurparta
komputiko = komputado, komputscienco
komputatoro = komputilo
komputero = komputilo
komputoro = komputilo 
komunikacio = komunikado, komunikaĵo (laŭ la kunteksto)
koncedi = allasi, konsenti, pravigi, deklari prava/e 
koncentra = samcentra
konĉerto = koncerto 
konfederacio = konfedero
konfronti = (en jura senco) kontraŭmeti; (en aliaj kuntekstoj laŭ la senco) kompari, interalfronti, fronti sin
konjugi = konjugacii 
konjunkcio = ligvorto 
konkludi = fini 
konkubino = kromedzino, kromvirino
konkubo = kunulo, vivkunulo, kvazaŭedzo.
konkurenco = (komerca) konkurado
konosamento = ŝarĝatesto, kvitanco
konotacio = kunsignifo
konseno = konsent-o, inter-konsent-o, aprob-o
konservativa = konservema, konservisma
konsilio = konsilantaro, konsilistaro 
konsistenco = kohereco
konsomeo = buljono
konstelacio = stelaro
konstipi = mallaksigi
konstipiĝi = mallaksi
konstitui = konsistigi, starigi 
konstruktiva = konstrua, progresiga, helpa
kontaĝi = infekti, transdoni malsanon 
kontanta = permona, mona 
konteksto = kunteksto 
kontenero = transportujo 
kontesti = diskute malakcepti, rifuzi, malkonsenti
kontralto = aldo
kontreo = kamparana muziko
kontribucio = = militkompenso
kontroli = regi, direkti
konuklo = ŝpinbastono 
konvaleski = resaniĝ-(ad)-i
konvekcio = kunfluado, suprenvento, alsupra vento
konvekti = kunfluigi
konverĝi = (laŭ la signifo en la konkretaj okazoj)(al)kuniri, kunflui, kuniĝi, kunceli, strebi kuniĝi
konversi = konversacii , interparoli 
konversacii = konversi, interparoli 
konverti = transformi, transigi, transkodigi
konvikti = pruvi (iun) kulpa 
kooperi = kunlabori
koopti = alelekti
koordini = kunordigi
kopuli = amori, seksumi 
kopulacii = amori, seksumi
korako = korvo
koramikino = amamikino
koramiko = amamiko
kordurojo = riphava veluro
korekta = ĝusta, senerara (Normale "korekta" signifas "rilata al korektado".) koresponda = kunliga, koincida, plua.
koridoro = irejo
korizo = nazkataro
korono = suna krono 
korporacio = akcia societo, firmao, kompanio
korpuso = tekstaro; (kiam temas pri parollingvaj materialoj) parolkolekto
korsako = tatara vulpo
korteza = korteguma, kortegeca, afabla, trobadora
korupti = subaĉeti 
koruso = ĥoro
kosmologo = kosmosciencisto
kosmologio = kosmoscienco
kosmonaŭto = kosmovojaĝisto
kosmonaŭtiko = kosmovojaĝado; kosmovojaĝscienco
kosmopolita = tutmonda
koŝmaro = premsonĝo, sonĝaĉo, timiga sonĝo 
Kotdivuaro = EburBordo
koterio = kliko, fikunularo
kovarda = malkuraĝa, malnobla
kozo = aĵo (se materia), afero (se spirita, abstrakta) 
krabli = mallerte marŝi 
kralo = bestokorto, bestejo
krapfeno = dolĉa fritbulo 
kraŝi = frakasiĝi 
kraŭlo = rampado
kreivo = kreopovo, kreemo 
kremo = (haŭt)ŝmiraĵo
krepiti = kraketi
krescento = lunarka formo, lunarko
krescenta bulko = lunarka bulko
krespo = patkuko
krifo = ungego 
kriminala = krima, prikrima
krino = (se temas pri ŝtofo) ruband-o; harego 
kripo = trogo , kradmanĝujo, staltrogo; (se temas pri kristnaska sceno) kristnaska sceno
kripta = sekrete konvencia, ĉifrita
kripto = subpreĝeja tombejo, subtera kapelo/ preĝej-(et-)o (laŭ la kunteksto)
kripto- = kaŝita
kriptografio = ĉifrteĥniko/teĥnikaro
kriptologio = ĉifroscienco
kriptonimo = kaŝnomo
kristanismo = kristismo
krita = sojla, lima; (se enestas ideo pri danĝero) kriza 
kritika = sojla, lima, kriza
kriulo = la kriula lingvo
krizolito = orŝtono (ĝenerale), gemo (ĝenerale), oliveno (kiel mineralo), peridoto (kiel juvelo)
kroĉo = okona noto 
kroki = skizi
krokizi = skizi
kroniko = kolumno, artikolo 
kronika = longedaŭra
kromo = ĥromo
kromio = ĥromo
kromatoforo = pigmentĉelo, pigmentoĉelo, pigmenta ĉelo, kolorĉelo 
kronologia = laŭtempa
kronologio = epokscienco, scienco de/pri datdifino 
krozo = ŝipvojaĝo 
kruasano = lunarka bulko
krucifikso = krucumito, krucumitobildo, kruco (laŭ la kunteksto)
ksantoforo = flavpigmentĉelo, flavpigmentoĉelo, flavpigmenta ĉelo
ksenofobio = fremdulmalamego
ksilografio = lignogravuraĵo
kuloto = pantaloneto
kulta = klera
kupreso = cipreso
kurento = elektro, elektrofluo
kurfo = elirmalpermeso, deviga hejmrestado
kurio = (vatikana) administrantaro/registaro
kurorto = kuracloko, feriloko, ripozloko
kurso = vojplano, vojlinio (referenca prezo de valorpaperoj, valutoj aŭ varoj aŭ relativa valoro de valutoj) = kurzo
kurta = mallonga
kurta cirkvito = fuŝkontakto, mallonga cirkvito, tuŝkontakto
kurtaĝo = makleraĵo  
kusineto = glitlagro, akstubo
kuspi = kontraŭfaldi, kontraŭkaresi 
kustardo = dolĉa saŭco, ova dolĉaĵo
kvaki = (rane) bleki 
kvarto = kvara intervalo. Vidu ssv plio 9
kvarterono = kvaronnigrulo
kvarteto = (en la senco de kvar kun-ludantoj aŭ kun-kantantoj) kvaropo, kvaro; (en la senco de verko por kvar) kvaropaĵo
kvecalo = kecalo
kver = transversa 
kveri = (kolombe) bleki/kanti, kolombumi 
kvesti = kolekti (monon aŭ aĵojn) (ĝenerale por religigaj celoj)
kviki = (muse) bleki
kvinto = kvina intervalo.
l' = la (krom en poemoj estas preferinde ne elizii la finan vokalon, kion oni neniam faras en la parolata lingvo)
labelo = kvalitmarko 
labialo = lipa konsonanto, lipsono
laĉo = ŝuligilo, ŝuŝnureto 
lagero = (hom)koncentrejo, (hom)mortigejo
lakona = malmultvorta
laktato = salo de lakta acido
lakuno = malplenaĵo, mankoloko
lancini = ade ekdolori
lanĉi = (komence) enuzigi, iniciati, komenci, surmerkatigi, ekfunkciigi, ekkonatigi, ekfamigi (vidu 9oa: lanĉi)
langvoro = malviglo, (dolĉa) melankolio, palo, senforteco
lanta = malrapida 
laringalo = glota konsonanto
laringito = laringinflamo
lasciva = voluptema
latero = flanko 
latino = latina lingvo
latiso = krado
latrino = (plej simpla) necesejo
latrono = ŝtelisto, ŝtelistego
laŭdneso (muziko) = laŭteco 
laŭtlegi = voĉlegi
lavabo = lavkuvo, lavopelvo, lavujo 
lavro = monaĥejo
lazo = kaptoŝnuro 
lefta = politike maldekstra
legaco = heredaĵo al aparta persono
legacio = diplomata misio
legala = laŭleĝa
legitima = laŭrajta
leĝera = malpeza, malserioza, senprudenta
lekcio = (universitata) prelego
lekcii = prelegi (en universitato)
lekciisto = universitata instruisto
leksikografo = vortaristo
leksikografia = vortarscienco
leksikologo = vortesploristo, vortstudanto
leksikologio = vortscienco
leksikono = vortaro, teĥnika/faka terminaro, terminaro
lekto = manĝolito
lektoro = universitata instruisto
leno = koridoro, vojo
(alteriĝa) leno = alteriĝa vojo, alteriĝa kurejo
leontodo = buterfloro
letala = mortiga
leŭ­koforo = blankpigmentĉelo, blankpigmentoĉelo, blankpigmenta ĉelo
levanteno = mezorientano
levanto = mezoriento
levitacio = leviĝo, sinlevado, ŝvebado
levrelo = leporhundo
lezi = (laŭ la signifo en la unuopa okazo) rompi, difekti, malobei, malplenumi, malrespekti, vundi
liberala = klera, klerula, neteĥnika (pri profesio); (ĝenerale) kleriga (pri eduko)
librotenado = kontado
lici = esti permesata
liceo = meza lernejo
licenco (en la senco de 'permesilo') = permesilo
lifa = maldekstra
liki = tralasi likvaĵon
likva = fluida 
likvaĵo = fluidaĵo
likvido (en lingvoscienco) = flua konsonanto 
likvo = fluidaĵo
lila = helviola, helmalva, siringokolora
limeso = limvaloro (en matematiko), limo 
limnologio = lagoscienco, lagostudo
linda = beleta 
lineara (en matematiko) = linia
lineo = kondukilo de elektro aŭ telefona signalo
lingvafrankao (en la ĝenerala senco de "interlingvo") = interlingvo
lingviko = lingvoscienco, lingvostudo
lingvistiko = lingvoscienco
linko = ligo, ligilo, ligadreso, kunligo
lirli = milde flustri 
(morta) litero = senefika, vana, senrezulta afero
litiazo = galŝtono, renŝtono, ŝtonetoj en la korpo, ŝtonmalsano
litosfero = firma terkrusto
liva = maldekstra. Vidu Ssv plio 15 
livida = pale blanketa
lizi = pruntaĉeti/pruntvendi, luaĉeti/luvendi
lizingo = pruntaĉeto/pruntvendo, luaĉeto/luvendo
lobio = premgrupo, influgrupo
lobii = (politike) prem(ad)i, (premgrupe) influ(ad)i, gruppremi
lobiado = (politika) premado, (premgrupa) influado
logogramo = vort(er)osigno
logoo = emblemo, marko, firmaa signo, vara signo, firmaa emblemo, vara emblemo.
logopedo = logopediisto
logotipo = emblemo
loĝistiko = provizarto, provizado
lokalizi = lokumi, loktrovi, lokdetermini, trovi lokon de
lokalo = ejo
lokio = postnaska elfluo
lokucio = dirmaniero, esprimo
lontana = malproksima 
loza = larĝa, malpremata 
lozanĝo = pastelo, fandpilolo
lucida = komprenkapabla
luĝo = glitveturil(et)o, sled(et)o
lukri = gajni, perlabori (monon), supergajni, elgajni
luksacio = elartikiĝo (Z), ostodifektiĝo
Luksemburgio = Luksemburgo, la lando Luksemburgo
lukti = batal/i 
lumbago = lumbodoloro
lumbalgio = lumbodoloro
lunĉo = tagmanĝo, tagmanĝeto, intermanĝeto
lupeo = grandiga lenso, grandigilo
lustracio = purigo per ofero, oferado, purigo, politika forigo (de homoj apartenantaj al nedezirata partio)
maato = ŝipa suboficiro 
maceri = solvi, trempsolvi
maĉeto = (arbar)tranĉilego
maĉo = ludo, konkurso, renkonto, duopa ludo
magazino = revuo
magra = maldika
magnetofono = surbendigilo, bendoregistrilo 
magnitudo = (en astroscienco) heleco; (en tertremscienco) tertremforteco, Riĥtergrado
Mahometo = Muhamado
mahometano = islamano
maieŭtiko = demanda metodo por trovi la veron, esplormetodo, debatmetodo, sokrata metodo
majeŭtiko = demanda metodo por trovi la veron, esplormetodo, debatmetodo, sokrata metodo
majo = la 5a monato
majlo = retmesaĝo
majoritato = plimulto (kvanto da homoj), plenaĝeco (rilate al aĝo)
majordomo = ĉefservisto
majusklo = ĉeflitero, grandlitero 
maĵora = pli granda, pli grava
maĵora tonalo = larĝa tonkombino 
maĵorio = plimulto 
maĵoritato = plenkreskeco 
maketo = modelo, etmodelo, modelaĵo
makiso = (mediteranea) arbustaro
makleri = peri, perante vendi
makro- = eg-, ega, grand-, granda, grandskala
makrocefalo = ambrobaleno
maksi- = eg-, ega, grand-, granda, grandega
maksimo = sentenco [fun]
maleo = (ligna) martelo; martelosto 
malfinia = senfina
malfinio = senfineco
malfluso = malfluo 
maligna = malbona 
maljam = ne antaŭ, ne pli frue ol, nur
maltiom = tiom malmulte
mamografio = mamobildigo, mamobildo
manaĝero = direktanto, direktisto, direktoro, estro, organizanto, administranto, mastrumanto
manaĝi = direkti, administri, mastrumi, estri
manaĝmanto = direktado, estrado, gvidado, estraro, direktistaro, administrado, mastrumado 
mandato = mandatperiodo
manikuri = manflegi
marabuto = marabutejo. Vidu krome ssv plio 2
marfrukto = (manĝebla, nefiŝa) marbesteto, maraĵo
marini = trempi 
marisko = (manĝebla, nefiŝa) marbesteto, marfrukto, maraĵo
marketo = merkato 
marketingo = surmerkatigo; merkatesploro
marono = (manĝebla) kaŝtano
maroto = ŝatokupo, amata ĉevaleto; (por redoni la signifon de la germana 'Marotte') manieto. Vidu Ssv plio 10.
marsko = ŝlimebenaĵo 
marto = la 3a monato 
martirologo = martirolisto, martirolibro
masakri = amasbuĉi, amasmurdi
masiva = solida
masklo = viro, virbesto 
maskoto = (en la senco de bonŝanc-alportanto) (ula/besta) talismano; (en la senco de ulo aŭ besto en emblemo) emblemulo, emblembesto
matadoro = bovbatalisto
matĉo = ludo, konkurso, renkonto, duopa ludo
matineo = matena prezentado/prezentaĵo 
matriarka = incentra, virincentra
matrono = edziniĝinta virino, matura virino, grava virino, respektinda virino
matutino = matena diservo 
mava = malbona
mazuto = peza oleo
meandro = (river)kurb(iĝ)o
media = komunikila, informila
mediato = (amas-)komunikilo, (amas-)informilo
mediatoro = peristo
medicino = kuracado, kuracscienco 
medikamento = kuracilo, medicinaĵo, sanigilo
Mefistofelo = diablo
Mefisto = diablo
mega- = miliono (en scienc-teĥnikaj vortoj), ega, bela, granda (en komun-uzaj vortoj)
meki = (kapre) bleki
mekko = mekao
melanoforo = nigra pigmentĉelo, nigra pigmentoĉelo, nigra pigmenta ĉelo 
melomanio = muzikomanio, muzikŝato 
memuaro = eseo, memoraĵaro 
men = malpli 
menaĝerio = bestejo 
meneĝmento = direktado, estrado, gvidado, estraro, direktistaro 
menstruo = monataĵo 
menŝo = ĝenulo; (se uzata admire) ruzulo
mentaleco = pensmaniero
mentoro = konsilanto
menuvero = sciurofelo
merdo = fekaĵo 
meretrico = prostituitino
mergi = tuttrempi, enakvigi 
meritokratio = merittaksado, meritulrego
merkatiko = merkatesploro/scienco
meronimo = vorto por parto de io, partovorto
meso = diservo 
mestizo = duonindiano
meta- = trans-
meteologio = veteroscienco
meteorologio = veteroscienco 
metodiko = metodoscienco
metodologio = metodaro, metodsistemo; metodscienco
metonimio = signifoŝovo, alisignifigo, (ekzemple: 'La kongreso' por 'La kongresanoj')
metro = mezurilo
metrologio = mezurscienco; mezurteĥnik(ar)o (laŭ la kunteksto)
metroo = subtera fervojo
metropoliteno = subtera fervojo
metropolo = ĉefurbo
mi- = muskol-
miaŭi = (kate) bleki 
miasmo = malbonodoraĉo
miceto = fungo
mido = tagmezo
postmido = posttagmezo
miito = muskolinflamo
mikoto = fungo
mikologio = fungoscienco, fungostudo 
mikro- = et-, eta, malgranda, malgrandskala
mikrokosmo = mondeto, etmondo, malgranda mondo
mikroondo = etondo
mikroonda forno = (et)onda forno, ondoforno, tujvarmigilo
mikrorakonto = eta rakonto, malgranda rakonto
mikrotomo = maldiktranĉa aparato
mili- = milono
minca = maldika 
mini- = -et- 
ministerio = ministrejo 
minora = malpli grava, malpli granda, malpli ĉefa 
minoritato = malplimulto (ekzemple da homoj), neplenaĝeco (rilate al aĝ-o) 
minusklo = malgrandlitero, etlitero, malĉeflitero
minuskla = eta, malgranda
miokardio = kormuskolo 
miozoto = neforgesumino
miriapodo = milpiedulo 
miringo = aŭdmembrano
mizogeno = (vir)inmalamanto
mitingo = (politika) amaskunveno, renkontiĝo
mitralo = maŝinpafilo 
mizantropo = hommalamulo, homevitulo
mizerikordo = favorkoreco
mizogino = (vir)inmalamanto
mjelo = spina medolo
mobila = poŝtelefono
mobilo = (kiel artaĵo) pendartaĵo, pendolaro; (kiel amuzilo por beboj) (beba) pendludilo/pendolaro
mocio = (oficiala) propono, (oficiala) postulo
moderatoro (en en atomkernenergia elektrofarejo) = moderigaĵo; (en retaj listoj aŭ forumoj) mastrumanto, administranto 
modli = modeli, formi, formumi 
mojosa = modernjunstila, laŭmoda, bonega, malaĉa, ŝatindega, bonuma
mokedo = plenplanka tapiŝo
molaro = maĉdento
mondialismo = tutmondiĝo
monismo = unuismo
monitori = kontroladi je distanco, fora kontrolilo
monitoro = ekrano
mono- = unu- 
monokromata = unukolora
monokulturo = maldiversa kultivado, unukultivado, unueckultivado, unuspeca kultivado.
monolatrio = unudiadorado
monologo = (teatra) solparolado
monoteismo = unudiismo, soldiismo 
monotona = unutona 
mopedo = (malgranda) motorbiciklo 
morbo = malsano 
morna = preme malĝojiga, malhela
moroza = malgajhumora
morta = senviva, mortinta, malviva
mortala = mortodeva
mortalo = mortodevulo, mortonto, mortemulo
mortosalto = cirklosalto
moskatelo = muskatelo = muskatvino 
moskeo = (islama) preĝejo
moskito = kulo 
moslemo = islamano
muslima = islama
moto = devizo
motivo = muzika temero
motokroso = motorkrozado
motorciklo = motorbiciklo
motuo = la motua lingvo
movimento = parto (de koncerto, simfonio aŭ aliaj muzikaj prezentaĵoj), muzikĉapitro
mucida = ŝimanta
muestro = (statistika) elprenaĵo
muĝi = (bove) bleki
mulato = duonblankulo, duonnigra homo, miksrasulo
multipliki = obligi
mungi = nazblovi, nazpurigi 
muskatelo = moskatelo = muskatvino 
mutili = stumpigi, kripligi, misformi, difekti, amputi
muzikalo = muzikteatraĵo, muzika komedio
muzulmano = islamano
na = povas simple esti forlasita aŭ anstataŭigita per -n, -on aŭ je (ekzemplo: mi studis Chomsky/Chomskyn/Chomskyon/je Chomsky) 
nabo = aksingo
nadlo = (kompas)montrilo, indikilo; pikilo 
najado = rivera aŭ fonta nimfo.
najlizi = alnajli, najlumi 
nano- = miliardono
narkomano = drogulo, drogmaniulo
natalitato = naskokvanto, naskemo, naskorilatumo
naturismo = nudismo
naŭno = naŭa intervalo, naŭto. Vidu ssv plio 9.
navo = ŝipo
navaho = navaĥo
navedo = glitbobeno
naveda servo = irreira servo, prameca servo
navigi = (en la senco de ŝip-vojaĝado) ŝipveturi, ŝipi; (en la senco de trovado de la pozicio) navigacii
navigilo = navigaciilo
navigacio = ŝipirado
nazala = naza
nazalo = naza konsonanto
necesabo = neceseja (sid)kuvo
nefro = reno
nefrektomio = forigo de la reno
nefrozo = rena malsano
nefrologio = renesploro, renstudo
nefrono = funkcia unuo de la reno
nefropatio = renproblemo, rendoloro, renmalsano
nefrito = reninflamo
negacio = neado, nea vorto
negativa = subnula, minusa
negi = nei 
negockarto = vizitkarto
negro = nigr(ahaŭt)ulo
nekrologo = mortraporto
neksta = sekva
nelge = antaŭ nelonge 
nen = neniel 
neo- = nov-
neofrono = kadavrogrifo
neolitiko = novŝtonepoko
neologismo = nova radiko, nova vorto, nova formo
nereido = mara nimfo
nervoziĝi = iĝi nerva, nerviĝi 
netransitiva (verbo) = netransira
netto = neto (pri pezo), neta pezo
neŭro- (en scienc-teĥnikaj vortoj) = nerv-
neŭrologo = nervisto
neŭrologio = nervomedicino, nervokuracado
nikotiano = tabak(-plant)-o
niksino = akvofeino
nito = rebatnajlo
nitrogeno = azoto Vidu Ssv plio 4
noci = malutili
nocio = koncepto, ideo, sciaĵo
noko = (kuirita) pasto/terpombuleto
Nordio = Nordlandoj
norena = malnovnordlanda (lingvo)
normalo = ortanto
notico = (mallonga) novaĵo
notora = fama, konata 
novembro = la 11a monato 
novico = monaĥiĝonto (en la senco de lernanto por iĝi monaĥo), = novulo, senspertulo (en ĝenerala senco)
nukleo = kerno 
numeralo = nombrovorto
nupto = geedziĝo
obeza = trodika, dikega, superpeza
objektivo = celo 
obĵeti = kontraŭdiri, kontraŭi, tameni 
oblato = (pola) kristnaska vaflo. (en la senco de hostio) hostio, (en la senco de sigel-aĵo) sigelilo 
oblonga = longforma
obscena = malĉasta
obskura = eksa, malnova, malaktuala
obstaklo = malhelpo, baro
obteni = akiri, ricevi
obtuza = malakra
oceanologo = marsciencisto
oceanologio = marscienco
ocelo = okulo
odontalgio = dentodoloro
-ofono = (kiel en 'Esperantofono') parolanto, lingvano
ofsajde = translime
ofsajdo = translimeco, translimiĝo; translima pozicio
oftalmito = okulinflamo
oftalmologo = okulkuracisto, okulisto
oftalmologio = okulmedicino, okulkuracado
oftalmometro = korneomezurilo
-oid- = -simil-
o kej = en ordo!, enorde!, jes!, bone!, ĝuste! 
OK! = bone! en ordo!, enorde!, jes!, ĝuste! 
okej = en ordo!, enorde!, jes!, bone!, ĝuste! 
oktavo = oka intervalo, okto. Vidu ssv plio 9.
oktobro = la 10a monato 
okso = virbovo
oksimoro = memkontraŭdiro, (ŝajna) sinkontraŭdiro, sinkontraŭdira esprimo.
olda = maljuna, malnova 
olfakto = flarsentumo, flarkapablo, flarpovo
oligarĥo = grupreganto, kelkregisto, kelkreganto
oligarko = oligarĥo
oligarkio = , gruprego, kelkregado
olim = iam, antaŭe, antaŭlonge
olimpiko = olimpiaj ludoj
olimpikaj ludoj = olimpiaj ludoj
-ologo = -sciencisto, -fakulo
-ologio = -scienco, -fako
ompiro = ludestro, arbitracianto, arbitraciulo
onirika = sonĝa
onkologio = tumorscienco, tumormedicino, kancerscienco
onomastiko = nomscienco.
onomatopea = sonimita, sonfigura
ontologio = estoteorio, estostudado
opcio = elekteblo, eblo, elekteblaĵo, elektorajto
operaco = agado 
operacio = agado
operklo = klapforma organo, osteca klapo (en la homa korpo), fermoklapo, kovrilo (ĉe fruktoj, abel-ĉeloj, kaj similaj)
operkulo = klapforma organo, osteca klapo (en la homa korpo), fermoklapo, kovrilo (ĉe fruktoj, abel-ĉeloj, kaj similaj)
oponi = kontraŭi, kontraŭstari, opozicii
opresi = subpremi
optima = plej bona
oracio = funebra parolado; oratoraĵo
orala = buŝa, voĉa
oranĝerio = oranĝejo
orbito = (en anatomio) okulkavo
oreado = monta nimfo
ordo = grupo; societo; klaso
ordeno = (laŭ la signifo) honorinsigno; societo/kunularo
ordini = pastrigi
ordinalo = (en lingvoscienco) orda nombrovorto; (en matematiko) ordonombro
organoleptika = spertebla per la sentumoj
orgojlo = fiero
orientalismo = orientismo, orientscienco, orientlandismo
orientalisto = orientisto, orientsciencisto, orientfakulo 
orkestro = muzikistaro
ornamento = ornamaĵo
ornitologio = birdoscienco 
ornitologo = birdosciencisto/fakulo
ornitorinko = bekmamulo, anasbeka mamulo
orto- = rekta, normala
ortangulo = rektangulo 
ortodencio = dentĝustigo
ortofonio = ĝusta (el-)parolo/prononco
ortofonisto = parolkuracisto
ortodoksa = ĝustapensa, tradicia, rektinstrua, pravakreda
ortodoksio = ortodoksismo, ortodokseco
ostaĝigi = garantikapti
ostaĝo = garantikaptito, garantiulo 
osteopato = ostokuracisto
ostopatio = ostodoloro, ostoproblemo, ostomalsano
oto = orelo
ota = orela
otalgio = oreldoloro
otito = orelinflamo, mezorelinflamo
otologio = orelstudo, orelscienco
otorinolaringoiatro = kuracisto pri orelo, nazo kaj gorĝo
otorinolaringologio = scienca studo pri orelo, nazo kaj gorĝo
otorinolaringologo = kuracisto pri orelo, nazo kaj gorĝo
otosalpingo = Eŭstakia tubo
ovri = malfermi
-oz- = -abund-, -plen-, -riĉ- (en la komun-uzaj vortoj), malsan-, inflam- (en vortoj de malsanoj). 
pacifismo = pacismo, pacamo
pacifisto = pacisto, pacamanto
pado = vojeto, pasejeto
paĥidermo = dikhaŭtulo, dikhaŭta mamulo
pajaco = amuzisto, ridigisto, klaŭno 
pajnto = duonlitro (mezurunuo por likvaĵoj en Britujo kaj aliaj anglalingvaj landoj proksimume egala al duona litro)
pakidermo = dikhaŭtulo, dikhaŭta mamulo
pakto = interkonsento, kontrakto
palatalo = palatosto; palata sono (laŭ la kunteksto)
palavro = (laŭ la kunteksto) diskutado, (inter)traktado, babilado
paleo = pra
paleografo = praskribesploristo
paleografio = praskribesploro
paleolitiko = praŝtonepoko
paleontologo = sciencisto pri pravivaĵoj
paleontologio = scienco pri pravivaĵoj 
palio = la palia lingvo
paliativo = dolormildigilo, simptomkuracilo
paludismo = malario, marĉofebro
pamfleto = kalumnia verketo 
panaceo = universala kuracilo, ĉionkuracilo/ĉiokuracilo
pandemio = tutmonda malsano
pandemonio = ĥaos(a lok)o, bruego, diabla loko
panenteismo = ĉioendiismo
panteismo = ĉiodiismo
pantero = genro de felisedoj
pansi = (kurace/protekte) kovri / ŝirmi (vundon)
pansaĵo = vundkovrilo; kuracbendo
pretpansaĵo = kuracbendo
papiamento = la papiamenta lingvo
para (en sciencaj vortoj) = apuda
paro = duopo
parafo = mallong(-igit)-a subskribo, subsigno, (en alia kunteksto) subskribornamaĵo
parafi = antaŭkonfirmi, (provizore) subskribi (mallongigite / komenclitere), subsigni, subskribeti, (en alia kunteksto) ornami subskribon
parafrazo = ĉirkaŭfrazo, ĉirkaŭskribo, ĉirkaŭdiro, ĉirkaŭparolo
paralimpiko = kromaj olimpiaj ludoj
paraolimpiko = kromaj olimpiaj ludoj
parapeto = protekta balustrado, randmureto
parati = haltigi (la pilkon), rebati, repuŝi, deturni, malhelpi
parcelo = terpeco
paregorika = dolormildiga
parfeo = ŝaŭmkrema glaciaĵo 
pargeto = lignoplanko 
parieto = vando 
parkere = (laŭ-)memore 
parmezano = parma fromaĝo
paroko = paroĥo 
parotido = saliva glando
parotidito = mumpso, salivglanda inflamo/ŝvelo, orelglanda inflamo/ŝvelo
partikulara = aparta
partio = ludo
partnero = kunulo, kunfaranto (anstataŭ 'far-' oni enmetu la radikon taŭgan por la situacio: kunkomercanto, kunloĝanto, ktp.)
parvenuo = novriĉulo; (en la kazo de homo, kiu abrupte akiris rangaltiĝon) elsaltulo , novpotenculo
paseo = pasinta tempo, pasintaĵo, pasinteco
paskvilo = akra satiro
paspartuo = universala ŝlosilo, ĉefŝlosilo 
pastoro = (protestanta) pastro
pastoralo = pripaŝtista verko, paŝtistomedia verko (en konkretaj okazoj oni povas esti pli specifa, ekzemple paŝtistomedia simfonio)
patato = batato, dolĉa terpomo
paternalismo = patrismo, patra sinteno
patezo = loka dialekto, loka lingvaĵo
patogena = (en komunuza lingvo) ekmalsaniga, malsaniga
patognomonia = malsanindika
patologio = malsanscienco
patologia = malsana, malsaneca
patrio = patrujo, patrolando
patriarka = vircentra
patriarko = familiestro
patronimo = patronomo
paŭperismo = malriĉeco
paŭti = ofendgrimaci, kolergrimaci, ĝengrimaceti
pecajo = ĉina brasiko
pedagogio = edukscienco 
pederasto = infanseksemulo, infanemulo, infanerotikulo
pederastio = infanseksemeco, infanemo, infanerotikemo
pediatrio = infanmedicino
pediatro = infankuracisto 
pedikuri = piedflegi
pedofilo = infanseksemulo
pedofilio = infanseksemeco, infanemo, infanerotikemo
pedologio = infanstudado, infanscienco; grundoscienco (en la senco de grundoscienco)
pedologo = infanstudanto, infansciencisto; grundosciencisto (en la senco de grundosciencisto)
pejĝilo = poŝmesaĝilo
pejorativa = malŝatesprima
peledo = (ĝenerale) buleto; (brulmaterialo) lignobuleto
peleto = (ĝenerale) buleto; (brulmaterialo) lignobuleto
pelilo = stirilo, kontrolilo 
pelmelo = mikskonfuzaĵo 
pelvometrio = pelvomezurado
penalo = punpiedbato (en piedpilka ludo)
pendolo = balancilo, pendilo
penseo = trikoloreto 
pensionato = fraŭlinhejmo, knabinhejmo 
pepi = (bird(-et-)e) bleki/kanti 
peplomo = plumkovrilo, vatkovrilo 
percento = elcent-(aĵ-)o
perceptiva = percepta, perceptopova
performanco = (laŭ la kunteksto) efiko, efikeco, produkt(okapabl)o, funkciado, prezento, plenumo
periklo = danĝero
perkelto = hungara saŭcoviando
perkuti = frapi
perlono = (germana) nilono, Perlon (varnomo)
perlueto = kajsigno (&) 
permanenta = daŭra, konstanta
permeabla = tralasa
pernio = frostinflamo, frostoŝvelo
perono = ekstera ŝtuparo
perpendikla = orta 
perpendiklo = ortanto
perpendikulara = orta 
perpleksa = konfuzita, dubanta, senkonsila
persieno = latŝirmilo,(persa) fenestrokovrilo, fenestroŝirmilo, rulkurteno
personalo = pronomo, persona pronomo; dungitaro, personaro, (labor)istaro
personalismo = personismo
personeco = persono, homo
personulo = (grava) homo, persono.
perturbi = malordigi, ĝeni, misfunkciigi
peruko = malvera hararo, nevera hararo
persvadi = konvinki 
pesko = fiŝkaptado
peticio = petskribo, petskribaĵo, petletero
petr- = ŝton-
petro = ŝtono, ŝtonaĵo
petrografio = ŝtonscienco
petrolo = benzino
pHmetro = acidecomezurilo
piĉo = vulvo, vagino
piero = marponto
pietato = respekto, pieco
pigra = mallaborema, maldiligenta 
piknometro = densomezurilo
piko- = milmiliardono
pikselo = bildero, bildopunkto, rastrumero
piktogramo = bildo, bild-simbol-o; vort-o-sign-o, bildoskribero (en kelkaj skrib-sistemoj)
pikturo = pentr(o)arto
pilĉardo = sardino 
piliero = subtenkolono
pimpa = gaje loga
pinastro = mara pino 
pindo = duonlitro, pajnto 
pinio = ombrela pino
pinka = rozkolora
pipelino = naftokonduktubo, flutransporttubo, tubarvojo
pipistrelo = vesperto
piranometro = (duonsfera) sunradimezurilo
pirheliometro = (rekta) sunradimezurilo
piro- = fajr(o)-
piromano = fajromaniulo
pirotekniko = fajrarto, fajrteĥniko
piroteknikaĵo = artfajraĵo, fajrofloroj
pita = malgranda, eta, malgrandaĉa 
pitĉo = tonalto 
pitoreska = bildeca, pentraĵeca,pentrinda, bildoimagiga 
pizango = nedolĉa banano
placebo = ŝajnkuracilo
plaĝo = (sabla) (mar-)bordo, banbordo, marborda banejo, sun(-um)-bordo, turisma bordo, strando. Vidu Ssv plio 5.
plaki = surlamenigi
plakato = afiŝo 
plano = (en petrado kaj metafore) ebenaĵo, tavolo, (en la esprimo 'unua plano') malfono; (en filmo) sceno
planto = kreskaĵo 
plasi = meti siajn ŝparaĵojn 
platbando = florbedo, bordero
platformo = partia programo, deklaro
platino = plateno
plebiscito = popolvoĉdono, popolkonsulto
pleonasmo = (lingva) troaĵo
plezuron! = Mi ĝojas!, [subkomprenita parto: estas al mi] (multa) plezuro, (viro diras al virino) [subkomprenita parto: mi estas] ravita [konatiĝi kun vi].
plonki = ignori, forĵeti
plozivo = eksploda konsonanto
pluki = deŝiri, rikolti (pri fruktoj, legomoj), depreni, eltiri; pinĉi (kordon de muzikilo); senplumigi, senharigi (ekzemple kokon)
plumo = skribilo, inkoskribilo, inkoplumo (en la okazo de efektiva birdo-plumo uzata kiel skribilo)
plumono = plumkovrilo, vatkovrilo 
plumpa = maleleganta, malgracia
pluralo = plurnombro, multenombro
plutokrato = riĉulreganto, riĉecreganto, riĉreganto
pneŭo = (rada) aerbendo
pneŭmo = aer, gas
pneŭmata = pergasa
pneŭmatiko = (rada) aerbendo
pneŭmatiko = gasmeĥaniko
pneŭmono = pulmo
pneŭmonito = pulminflamo
pneŭmonio = pulminfekto
pneŭmopatio = pulmmalsano
pobo = ŝipvosto 
poĉi = (pri ovoj) senŝele boligi; (pli ĝenerale) boletigi
podkasto = elŝutradio, retabonebla radio 
podologio = grundoscienco, grundostudo
podologo = grundosciencisto, grundostudanto
poefago = gjako= gruntbovo, tibeta bovo
poento = valorunuo, taksunuo, unuo 
poeto = poemisto, poemverkisto, versisto 
poeziaĵo = poemo, versaĵo
poezio = poemeco, poemarto, verseco, versarto, poemaro 
pojno = manradiko 
poka = malmulta
poldero = senmarĉigita marregiono
polekso = dikfingro 
polemologo = militosciencisto
polemologio = miltoscienco, militostudo
poli- = mult-, plur-
poliandrio = pluredzeco
poligamio = pluredzeco
poliginio = pluredzineco
poligloto = multlingvulo
poligono = plurangulo
polikulturo = multkultivado
polio- = griza mjela substanco, mjelosubstanco
polio = infana paralizo
poliomjelito = infana paralizo
polipneo = rapida spirado
polisemio = plursignifo, plursignifeco
politeismo = plurdiismo, multdiismo
politeisto = plurdiisto, plurdiismano
polmo = manplato, mankavo 
poltrono = malkuraĝulo
polucio = (nevola) spermeligo, spermelfluo
polucio = poluado 
pomelo = tenilo
populacio = (baza, esplorata) tutaĵo
populismo = popolismo
poro = tru(et)o, kav(et)o
poroza = truethava, tralas(em)a
porĉo = portiko, portikaĵo
poriĝo = avenkaĉo
portalo = (ret)pordego; pordego
postea = posta
postiĉo = falsaĵo, imitaĵo
postkropo = maĉostomako, poststomako 
postmido = posttagmezo
poterno = pordo
poŭlo = pullo = (akvo-)rezervejo
povra = bedaŭrinda, kompatinda
pozitiva = supernula, plusa
prato = herbejo
pre = antaŭ
preamblo = antaŭparto, enkonduko, prezentteksto
precedenco = antaŭekzemplo
precedenca = (ĝis nun) nekonata, antaŭe ne vidita, senkompara, nekomparebla, sen antaŭaĵo, sen antaŭa similaĵo, senegala (lau la kunteksto)
precedento = antaŭekzemplo
precioza = (laŭ la kunteksto) afektoplena, afektema, afektita, delikata, rafinita; (en la senco de valorega) valorega
precipiti = (en la senco de veteraj fenomenoj) (al)fali; (en ĥemio) sedimenti, malsolviĝi (se la subjekto estas la nesolvotaĵo), malsolvigi (se la subjekto estas la homo kiu kaŭzas la precipiton)
precipitaĵo = (veter)alfalaĵo
predi = ĉasi, ĉasakiri
predo = kaptaĵo, ĉasaĵo
prefaco = antaŭparolo
preferi = pliŝati
prefiks'o = antaŭafikso, antaŭmetebla vortero
premiero = unua prezentado (teatraĵo aŭ filmo), ĉefministro (reg-ist-ar-a posten-o)
premiso = antaŭkondiĉo
preni = ekveturi per, veturi per, iri per, uzi, utiligi
prepucio = (penisa) antaŭhaŭto
prerio = herbejo (se la emfazo estas pri la herbo), ebenaĵo (se la emfazo estas pri la vasteco kaj ebeneco)
pres- = gazetara 
preskripto = pretertempeco, neplupuneblo, fortempiĝo
preskripta = pretertempa, neplupunebla
preterito = pasinta tempo
preventi = malhelpi, antaŭmalhelpi, malebligi
preventa = (en la senco de milito) antaŭataka, malhelpa
prezenco = nuntempo
prezidento = (ŝtat-)prezidanto 
prezidio = prezidejo (se temas pri la fizika loko), prezidantaro, estraro 
primo = unua (intervalo), unuto. Vidu ssv plio 9.
primara = unuaranga
primavero = printempo 
primuso = varmigilo, kuirileto
printi = presi, elpresi (el komputilo), komputilpresi
prioritato = antaŭrajto, antaŭrangeco
prizono = malliberejo 
probabla = verŝajna
problematiko = problemaro, malfacilaĵaro
procento = elcent-(aĵ-)o. Vidu Ssv plio 7. 
prodigi = malŝpari, forneniigi
prodo = bravulo, (mezepoka) kavaliro 
producento = (film)produktadestro
produktiva = produktopova
produktoro = (film)produktadestro
profana = nereligia, laika, malsankta 
profani = malsanktigi, malobservi la sanktecon de
profano = nereligiulo, homo neinstruita pri sanktaĵoj, neinicito, laiko, nekompetentulo, ne-spert-ul-o
prohibi = malpermesi
prokrasti = malfruigi, postigi 
prolongi = plidaŭrigi
prominenco = elstaraĵo
prominenta = elstara, pli/plej elstaranta
promocii = (en senco komerca aŭ ĝenerala) antaŭenigi, disvastigi, stimuli, akceli; (rang-altigi) rangaltigi
prompta = tuja, vigla, senprokrasta
prompti = preti, esti preta
promulgi = oficiale eldoni, anonci
proni = tordi la brakon malsupren
prononci = elparoli 
propagi = disvastigi, disfamigi
proparolanto = porparolanto
propedeŭtiko = enkonduka instruado, prepara instruado, antaŭinstruo (en Esperanto oni uzas la koncepton ĉefe pri 'la propedeŭtika/lingvenkonduka valoro de Esperanto rilate al aliaj lingvoj') 
proprieto = rajto, jura posedrajto
proprietaĵo = havaĵo, propraĵo
propulsi = (antaŭen)peli (maŝinon)
proskribi = ekzili, eksterleĝigi, malpermesi
proskripcio = ekzilado, eksteleĝigado, malpermesado
prospektoro = minaĵesploristo
protagonisto = ĉefrolanto, ĉefrolulo
proto- = pra-, unua
prototipo = pratipo, pramodelo
provosto = policestro
prozopopeo = personigo (paroligi ion aŭ mortinton kiel personon), aroganteco, fiereco (laŭ la senco uzata en kelkaj landoj)
pruo = ŝipkapo, ŝipantaŭo 
pseŭdo = ŝajn, kvazaŭ, mensoga/e, malvera/e
pseŭdoafikso [zam+1oa]] = ŝajnafikso
pseŭdonimo = kaŝnomo, plumnomo
ptarmiko = terniga herbo
pubera = seksmatura
pubio = pubosto
pubiotomio = tranĉo de la pubosto
puĉo = ŝtatrenverso
pudendo = intima parto, privataj partoj, sekreta parto, pubregiono; (rilate al la 'pudenda nervo') pubanusa nervo
pudingo = flaŭno
pugo = postaĵo, sidvangoj 
pulardo = dikigita kokino (manĝebla dum festotagoj, tipa en Francujo)
pulko = agavvino
pullo = poŭlo = (akvo-)rezervejo 
pululi = svarmi, multiĝi 
punika = kartaga
puniko (loĝanto de Kartago) = kartagano
punkcii = eltiri (likvaĵon) (ankaŭ en kuraca senco)
punkturo = piko (de la haŭto por kuracaj celoj)
puntilio = kaprico, insisto pro honoro
pupo = krizalido (ne nur por papilioj sed por ĉiuj insektoj)
pureo = kaĉo
purpura = violkolora
putino = prostituitino, ĉiesulino
puzlo = kunmetenigmo
rabbi = rabeno
rabdismo = vergodivenado
rabdisto = vergodivenisto
rabdo = divenvergo
rabdomancio = vergodivenado
racionala = racia
racionalismo = raciismo
racionalo = frakcia, kvocienta, rilata nombro
radiatoro = hejtilo; malvarmigilo
radikalo = radikaĵo, vortobazo; (pri ĉina skribo 部首) fakindikaĵo, klarigilo
radiklo = nervradiko
radiofono = radioricevilo
radiofonio = radiosendado
radiografi = radiobildigi
radiologo = radikuracisto
radiologio = radikuracado
radioskopio = perradia esplorado
radioterapio = radiadokuracado 
radiuso = antaŭbrakosto
raguo = (laŭ la kunteksto) stufaĵo; saŭco
raĝo = hinda reĝo 
rajpi = frotfiksiĝi
raĵao = hinda reĝo 
rakedo = batilo, tenisbatilo 
rako = bestmanĝujo 
ramo = murrompa trabo, rompotrabo
ramplo = deklivaĵo, dekliva vojo, dekliva tabulo, en/elira vojo
ramuro = (cervaj) (branĉ)kornoj, (cerva) kornobranĉaro
rangifero = norda cervo
rankoro = nepardonemo, venĝodeziro, malamo
rankuno = nepardonemo, venĝodeziro, malamo
raporto = proporcio, rilatumo
rara = malofta, altvalora (pro malofteco)
raslo = spirbruo
rastro = fosilo, pioĉo. 
ratifi = (leĝe) konfirmi
ratifi = (leĝe) konfirmi
ratio = proporcio, rilatumo
raŭfo = (porbesta) manĝujo 
raŭndo = fazo, stadio, rondumo, er-o, vico, ŝtupo 
raŭndejo = areno 
raŭto = vojplano, vojo
ravino = abismo 
razeno = herbotapiŝo, herbetejo, herbobedo
razio = rabatako, rabkaptado, prirabado; (pri polica agado) amasarestado
reakcio = (en ĝenerala, nepolitika senco) reago
rebo = vinbertrunko
recidivo = remalsano, rekrimo (depende de la kunteskto medicina aŭ jura)
recidivulo = remalsanulo, rekrimulo (depende de la kunteskto medicina aŭ jura)
recitalo = (unupersona) koncerto, unupersona prezentado
reciti = deklami
redakcio = redaktejo, redaktistaro, redaktaĵo, redaktversio
redaktoro = redaktisto, redaktanto
redempti = savi, elaĉeti
Redemptoro = Savinto, elaĉetinto
redundo = supersufiĉo, ripeteco, (inform)abundo, balasteco
redundanco = supersufiĉo, ripeteco, (inform)abundo, balasteco
reduto = fortikaĵeto 
reelo = reala nombro 
refektorio = (monaĥeja) manĝejo
referato = (scienca) raporto, (stud)raporto
referendumo = popolkonsulto, popolvoĉdono
refleksio = pripenso
reflekti = speguli, reĵeti, resendi, rebrili, reradii
reflektoro = (ĝenerale) reflektilo; (astronomia ilo) spegula teleskopo
reformacio = (protestanta) reformo 
reformatoro = reformanto, reformulo, reformismano
refraktara = fajreltena, fajrorezista, fajrimuna
refraktometro = refraktomezurilo
refraktoro = (ĝenerale) refraktilo; (astronomia ilo) lensa
regardi = rigardi (plej ofte simpla eraro), alte estimi (foje)
regatto = boatfesto
regeneracio = regenerado
regento = (provizora) reganto
regio rarr; (publika) administrado/mastrumado, publika) kompanio
reglamenti = reguligi
reglamento = regularo
regulatoro = reguligilo
rehabiliti = (en medicina senco) rekapabligi, readapti; (en jura aŭ ĝenerala signifo) rehonori
rejŝo = proporcio
rekcio = reg(ad)o
reklamacii = plendi
reklamacio = plendo
rekogneski = esplori
rekognoski = esplori
rekomendita = registrita
rektifi = (ĥemie, mekanike) ĝustigi, (elektre) samdirekti, (geometrie) rektigi
rektifiki = (ĥemie, mekanike) ĝustigi, (elektre) samdirekti, (geometrie) rektigi
rektumo = rekta intesto
rekuperi = reakiri
relajso = plusendilo, ŝaltilo 
reluktanco = (komunlingve) magneta rezistado
remanenco = (komunlingve) restanta magneteco
remburse = repage
remio = egala rezulto, nenies gajno
remiso = egala rezulto, nenies gajno
remisa = egala, senvenka, senrezulta, sen-decid-a, sen-venk-a
remito = (en medicino) malpliiĝo
remorki = treni
remorko = postveturilo, trenveturilo, postĉaro, trenĉaro
remtero = (monaĥeja) manĝejo
rendimento = efiko, efikeco, produktokapablo
renegato = kredorifuzanto (pri religio), transpasanto al alia partio (en politiko)
rentabilitato = profitkapablo, profitdono
renoma = (bon-)fama; kun bona reputacio
renomo = famo, diskonateco; (bona) reputacio
renonci = rezigni 
reologio = fluadoscienco
reparacio = ŝuldopago, kompensopago, militkompenso
repelenzo = malallogilo 
repetitoro = instruripetisto, privata instruisto
repliki = respondi
reportero = raportisto
repudii = forsendi, eksedz(in)igi, forigi, eksigi
resolucio = detaleco, distingopovo, bilderdenseco
resoluta = decidinta, firma, certa
respektive = aŭ, kaj (laŭ la kunteksto)
responsi = respondeci, respondumi
responsulo = respondeculo 
restitui = redoni
restrikti = limigi malvastigi
resurco = rimedo, riĉofonto, naturriĉaĵo
resurekti = reviviĝi, releviĝi 
resurso = rimedo, riĉofonto, naturriĉaĵo 
retikulo = mansak(-et-)o 
retrati = repreni (monon el banko)
retreto = malantaŭeniro 
retro- = reen, malantaŭen, dorsodirekte, re-e
retrokuplado = rekorekto
retrospekte = rerigarde
revanĉo = nova ludo 
reverso = dorsflanko
revuo = (fak-/ese-/kritik-/semajn-)gazeto 
reziduo = restaĵo
rezisti = kontraŭstari
rezistanco = rezistokvanto, rezistilo (en elektraj cirkvitoj)
rezoluta = firma, decidinta, certa
rezultato = rezulto 
ri = ŝi aŭ li, ŝili, ĝi
riceli = kaŝi ŝtelaĵon
ricelisto = ŝtelaĵokaŝisto, fiaĉetisto
rifo = ripetfrazo
rikoĉeti = resalti
rikordo = registraĵo 
rilaksi = senstreĉiĝi, malstreĉiĝi
rilativo = ktabelvorto
rimorso = konsciencriproĉo 
ringo = boksejo, boksa podio, pugnobatala podio
rino- = nazo
rinito = nazkataro, nazmukozinflamo, nazinflamo
rinologio = nazstudo
rinoplastio = nazoperacio
rinoskopio = nazesplorado
riporti = raporti (en gazetoj, televido, ktp.) 
riposti = rebati
risurco = rimedo
ritmenbluso = ritmo kaj bluso 
ritualo = rito, ritaro
riveli = aperigi, malkaŝi, malkovri
rivolui = ĉirkaŭsiturni, memturniĝi
rizorio = ridmuskolo
rizoto = (itala) rizaĵo
rodi = ronĝi
rojo = rivereto 
rojalismo = reĝismo
rojalisto = reĝisto, reĝismano
roko = rokenrolo
romancero = romancaro
romantismo = romantikismo 
rondaŭo = rondpoemo 
rori = leone bleki
rosino = sekvinbero, seka vinbero 
roto = taĉmento
rotao = Rotao (nomo), papa juĝejo
rotacii = turniĝi
rotatoro = rotacia aĵo, rotacia muskolo
rotoro = (en la senco de helico) (vertikala) helico, levhelico; (en la senco de turniĝanta stango) akso; (en la senco de turnebla kerno de dinamomaŝino aŭ elektromotoro) rotacikerno, turniĝkerno
roverso = refaldo, malantaŭo, malantaŭa flanko 
rubriko = titol( et )o, artikolo, kolono 
rui = trempi
rufa = ruĝe flava, ruĝflava
rufo = ferdeka domo
ruĵo = lipoŝminko, lipruĝo 
rukuli = kolombe bleki/kanti, kolombumi
rulsketiloj = rulŝuoj 
rumoro = bruo
rumsteko = dorsa bovtranĉaĵo
rundo = patrolrondiro, balotado
rungo = stangoŝtupo 
rura = kampara, malurba 
ruro = kamparo 
rustika = kampara, kampareca, malurba 
sa = saluton!
sabeliko = krispa folibrasiko
saboti = intence difekti, subfosi
sacerdoto = pastro 
sadhuo = saduo
safena = krurvejna
sagitario = arkpafisto
sakeo = rizvino
sakra = sankta
sakri = blasfemi
sakrala = sankta, malprofana 
sakrilegia = malrespekta (pri religiaj aferoj)
sal = saluton!
salamo = spickolbaso, seka kolbaso (laŭbezone kun aldona specifiga vorto, ekzemple "hungara spickolbaso")
Saloniko = Tesaloniko
salpingo = utera tubo 
salpingito = utertuba inflamo 
salsa = saluton!
saltiero = (longa) kolĉeno
salubra = saniga, sana, sanfavora, nemalsaniga
salveto = buŝtuko, salivtuko 
samplo = (statistika) elprenaĵo
Samsono = Ŝimŝono
sangadulto = (en-)familia seksumado, (en-)familia malĉastaĵo
sango malvarma = memrego (la antaŭa esprimo iĝas 'mem-reg-e')
sanatorio = saniĝejo
sangvina = gajhumora (laŭ unu kompreno de la vorto); fajra, arda, impeta (laŭ alia kompreno de la vorto)
sangvino = ruĝkrajona desegnaĵo
sanitara = prisana
sankcio = malpermeso, puno
sanskrito = la sanskrita lingvo
sapeo = subfosaĵo
sapero = fossoldato
saporo = gusto, kromgusto
sarmento = vinberbranĉo 
satisfakcio = kontento, (pri dueloj) eblo dueli, (en religio) kompenso pro pekoj
saturnalioj = saturna(j) festo(j)
saŭdado = nostalgio, hejmsopiro
saŭno = ŝvitbanejo
saŭrkraŭto = acida brasiko
savi = konservi
sbiro = fipolicisto, policistaĉo
scintili = trembrili, brilflagri
seanco = kunsido 
secesio = (en internacia juro) disiĝo, apartiĝo; (arta stilo de la komenco de la 20-a jarcento) = novarto. Vidu Ssv plio 14.
sedativa = trakviliga
sedativo = trakviligilo
sefo = sekurŝranko
seismo = tertremo
seismografo = tertremregistrilo
seismogramo = tertremregistraĵo
seismologo = tertremosciencisto, tertremfakulo
seismologio = tertremoscienco
sejmo = (pola) parlamento
sejno = (akvomeza) trenreto, tirreto
sekretariato = sekretariejo, sekretariaro
seksto = sesa intervalo, sesto. Vidu ssv plio 9
sekulara = nereligia, civitana
sekularizi = igi nereligia
sekundo = dua (intervalo), duto. Vidu ssv plio 9
sekundara = duaranga
selekti = elekti, apartigi; (pri bestobredado) bredelekti, elektobredi
selektiva = disigkapabla 
semaforo = trafiklumo
semantiko = signifoscienco
semestro = ses monatoj, sesmonata periodo, duonjaro, jarduono; (pro influo de naciaj lingvoj, foje la intencata signifo povas esti alia, kaj tiam oni devas traduki laŭ la efektiva signifo)
semi- = duon-
semido = ŝemido
semito = ŝemido
semolo = (tritikfaruna) grieto
sencumo = direktumo
senila = kaduka
senjoro = sinjoro, maljuna sinjoro
sensaco = reago, sentumado 
sensiva = sentema
sensivo = sentkapablo 
senso = sentilo, sentumo 
sensora = senta, percepta
sensorio = sentilcentro
sensualismo = sentismo
sentinelo = gardanto, gardostaranto 
sentenco = (en la senco de 'frazo') frazo
separeo = apartejo
separi = disigi 
sepsa = infekta, putriga
sepsemio = sangoveneniĝo
sepso = infekt(iĝ)o, putriĝo
septembro = la 9a monato
septimo = sepa intervalo, septo. Vidu ssv plio 9. 
septo = maldika vandeto
serendipo = (kapablo je) hazarda malkovro, (kapablo je) hazarda trovo
seroterapio = serokuracado
serpo = falĉileto, rikoltilo; haktranĉilo
servico = teleraro, manĝilaro 
servila = troservema, servemega, humilaĉa 
serviro = komenca bato, alservo, prezento
seto = ludaro, serio, ludserio
setli = ekloĝi, fiksloĝi, enloĝiĝi, loĝestabliĝi, kolonii
siesto = dumtaga dormeto, posttagmeza dormeto
siglo = nommallongigo
signaturo = subskribo, nomsigno, faldomarko
silvestra = jarfina
Silvestro = jarfino, jarfina festo, jarfina nokto
simpatii = (en la senco de kunsento) kunsenti
simultana = samtempa 
sinagogo = (hebrea) preĝejo. Vidu ssv plio 11. 
sindromo = simptomaro
sinestezio = sentumligiĝo, kunsentumado, (en literaturo) dusentuma esprimo, dusentum-(aĵ-)o
singularo = ununombro
sinistra = malbonaŭgura, timinda
sinistro = akcidento
sinki = subakviĝi, alfundi, alfundiĝi, droni, malleviĝi, enfali, perei (en la okazo de ŝipo)
sinkrona = unutempa, samtempa
sinonimo = samsignifvorto 
sintagmo = frazero
sintonizi = agordi (sian aparaton laŭ), enŝalti (en...)
sinuo = serpentumo, kurbo, serpentuma kurbo 
sinusito = vangokavoinflamo ?????
sinusoida = sinusforma
sinusoido = sinusforma kurbo
siro = (reĝa) moŝto 
sismo = tertremo
sismografo = tertremregistrilo
sismogramo = tertremregistraĵo
sismologo = tertremosciencisto, tertremfakulo
sismologio = tertremoscienco
sisopo = sistemestro, (sistema) administranto
sito = loko, ejo, loĝloko, retejo
sitkomo = komedio, situacia komedio, televida komedio
skabelo = piedripozilo, piedseĝo, piedapogilo
skafaldo = konstrutrabaro
skalpo = kaphaŭto
skeleto = (homa) ostaro
sketejo = glitkurejo 
sketi = glitkuri
sketilo = glitilo, glitkurilo, glitŝuo 
skettabulo = glittabulo, rultabulo
skipo = teamo, taĉmento
skoldi = riproĉi, mallaŭd-(eg)-i 
skolopendro = (ne en faka uzado) centpiedulo
skopofilio = (seks-)rigardismo
skoriisto = konkursvojisto 
skotero = motorcikleto 
skovelo = cilindra broso 
skrapgumo = viŝgumo 
skrutinio = kontrolo de voĉdonaj rezultoj
skualo = ekventego, subita ventego
skulpturo = (laŭ la signifoj en la unuopaj kuntekstoj) skulptaĵo; skulptarto; skulptado
skuti = paŝruli
skutilo = paŝrulilo
skvaro = placo, ĝardenplaco, placeto, placĝardeneto
skvaŝo = murteniso
slabo = (marmora/ŝtona/betona) plato/tabulo 
slajdo = lumbildo
slamo = kvartalaĉo, ladvilaĝo
slango = (en la senco de ĵargono, socia dialekto) ĵargono [1oa], socia dialekto; (en la senco de faklingv(aĵ)o) faklingv(aĵ)o. Vidu Ssv plio 16 
slavono = la slavona lingvo
slogano = frapfrazo
slumo = kvartalaĉo, ladvilaĝo
smajlo = rideto
SMS = (telefona) mesaĝ(et)o, poŝmesaĝo, etmesaĝo 
snejlo = heliko
snajpero = kaŝpafisto, celpafisto
snoba = supereca, klaskonscia
snufi = enspiri, ennazi
sob = malsupren, suben 
socilingvistiko = socilingvoscienco
sociologo = socisciencisto
sociologio = sociscienco
sodomii = anuse seksumi
sofistikita = rafinita, teĥnike kompleksa, malnaiva, ellaborita
softa = mallaŭta 
softvaro = program(ar)o
soko = plugiltrabo
solecismo = (lingva) eraro
solicitoro = jura prokuristo, advokatasistanto
solstico = sunhalto, sunekstremo
solventa = pagokapabla, pagopova
somato = korpo
sombra = mallumeta, malhela, malgaja
somiero = matracingo, matractenilo
somnolo = dormemo, duondormo
somoso = (telefona) mesaĝ(et)o, poŝmesaĝo, etmesaĝo 
sor = supren 
sori = supreniri, leviĝi
sordida = malpura, aĉa
spaciala = spaca, kosma
spagato = diskrurado(gimnastiko)
spajro = turpinto (de preĝejo) 
spamo = (reta) trudmesaĝo 
spami = (rete) trudmesaĝi
spamisto = (reta) trudmesaĝisto
spano = (baza mezur-unuo) manlarĝo; (parolante pri konstruaĵo) apogdistanco; (ĝenerale) larĝo, amplekso
sparko = (elektra) fajrero
specialisto = fakulo
specio = (besta aŭ kreskaĵa) speco 
spektatoro = spektanto
spekulacio = spekulado
spekulacii = provi diveni
speleologio = kavernoscienco
speleologo = kavernosciencisto
spermato- = sperm(o)-
spiranto = frota sono, frota konsonanto
spirituala = spirita, spiriteca
spiritualismo = spiritemismo, spiritecismo
spoko = (rad)radio
sponsoro = patrono, kunfinancanto, financa subtenanto
spontana = natura, nature naskita, nature apera, memnaska, mem- apera 
spontanea = spontana
sportiva = sporta, sporteca, lojala 
spraji = ŝprucigi
sprinti = ekkuri
sproso = ĝermo, burĝono, ĝermoplanto, plantido
staĝo = kurso, kurseto
stako = amaso (malsamspecaj objektoj), kolumno (samspecaj aferoj unu sur la alia), aro
stalono = virĉevalo 
stamfi = piedbati kolere, piedpremi
stamo = radiko
stanco = (en la signifo de "strofo") strofo (la vorto "stanco" nur estu uzata kiel fakesprimo por certa italdevena speco de versaĵoj kun rimskemo abababcc); (en palaco) (ornamita) ĉambrego 
stando = budo, informbudo, ekspozicia budo
standarda = norma
standardo = normo
-stan- = -land-, -uj-
stapedo = piedingosto
staplo = stokejo 
starosto = (pola) provincestro
starti = eki, ekiri, ekfunkcii
stas = estas
statiko = ekvilibroscienco
statisto = figuranto, etrolanto
stativo = starigilo 
staturo = (homa) alteco 
steĥiometrio = ĥemia kalkulado
steko = viandotranĉaĵo
stekiometrio = steĥiometrio, ĥemia kalkulado
stenografio = stenografado, stenografsignaro, stenografarto (laŭ la kunteksto) 
stereotipo = kliŝo, ŝablono, kliŝŝablono, ŝablonkliŝo, ĝeneralaĵo, malorginalaĵo
sterila = senfrukta, sennaska, senĝerma
sternumo = brustost'o
stevardo = dumfluga helpisto, dumfluga helpanto, pasaĝerprizorganto, aviadila helpanto 
stif- = vic-, duon-, eduk- 
stilistiko = stilscienco
stilzoj = altiriloj 
stinka = fiodora, odoraĉa, malbonodora, haladza
stinki = fiodori, odoraĉi, malbonodori
stomato = buŝo
stomatologo = dentisto, dentkuracisto, buŝkuracisto
stompo = maldensigilo de linioj
stop! = haltu (ekkrio), punkto (en telegramoj)
stopi = haltigi
stori = konservi
stovo = varmigilo, varmigforno, hejtilo 
strando = (sabla) (mar)bordo, banbordo, marborda banejo, sun(-um)-bordo, turisma bordo. Vidu Ssv plio 5.
strangoli [9oa] = sufokpremi, sufoki
straso = ŝajna juvelo
stratumo = tavolo
streso = streĉo, (nerva, mensa) (tro)streĉ(iĝ)o
streta = mallarĝa
strikta = rigora, rigida (pri leĝ-o, kondut-o, ktp.), mallarĝa, malvasta, streĉita, streĉe alĝustigita (pri vestoj)
stringi = ĉirkaŭpremi
striptizo = ekscitnudiĝo
studento = studanto, lernanto
stukaĉo = denuncul-(aĉ)-o 
stumbli = (pro mispaŝo) faleti, ŝanceliĝi, mispaŝi, falpuŝiĝi; (en figura senco) erareti, mispaŝi
stuporo = mirego, surprizego, ŝokiĝo, surprizo
stupro = seksperforto 
sturmi = kurataki
subgenro (pri bestoj kaj kreskaĵoj) = subspecaro
subjunkcio = subordiga vorto/ligvorto
sublima = bonega, noblega
sublimato = sublimaĵo
submarino = submarŝipo
subreto = servistino, ĉambristino (en teatraĵo), aktor-in-et-o, et-rol-ul-in-o, an-o de danc-ist-in-ar-o (en amuzaj teatraj spektakloj)
subsidiara = helpa, aldona, aldonhelpa, duavica, malcentre decidita
subsidiareco = malcentra decidpovo
substantivo = ovorto, nomvorto 
substrato = subtavolo 
subtitoloj = subtekstoj
sufikso = postvortero, postafikso 
sufloro = flustri, flustristo 
suĝeto = intrigo, rakonto, temo
suicido = sinmortigo
sukcedi = sekvi, esti heredanto 
sukoto = (festo de la) laŭboj 
sukuri = tujhelpi, ekhelpi, ekkuraci, doni unuan helpon
sukuristo = tujhelpisto, ekhelpisto
superba = impresa, belega
supermarkto = supervendejo, superbazaro, vendejego
supermerkato = supervendejo, superbazaro, vendejego
supini = turni la antaŭbrakon al la ĉielo.
supla = malrigida
surao = ĉapitro
surda = senvoĉa, malsonora, obtuza
surjekcio = surĵeto, chioncelanta funkcio, sura funkcio
surogato = anstataŭilo, anstataŭaĵo
suspendi = provizore haltigi (funkciojn, efikon)
suspenso = streĉo, streĉatendo
suspensio (en la meĥanika senco) = risortumo
suspiri = vespiri, sopirĝemi
suturo = (kuracista) kunkudro
suveniro = memoraĵo
suzereno = feŭda sinjoro
svaga = malpreciza 
svahilo = (la) svahila (lingvo)
svelta = (bele) maldik(et)a
svetero = pulovero/pulovro
svingilo = balancilo, pendolo.
ŝafto = pela akso, turnoakso
ŝalmo = trinkotigo, trinkopajlo 
ŝamo = ĉamohaŭto 
ŝamoto = fajrorezista materialo, fajroeltena argilo
ŝampinjono (en la ĝenerala senco de 'fungo') = fungo
ŝampuo = harlavaĵo, harlavilo
ŝanelo = la plej profunda parto de maro/rivero
ŝari = kunhavi
ŝarifo = araba princo 
ŝaŭro = pluvoverŝo, pluvekverŝo (povas temi ankaŭ pri 'neĝo' aŭ 'hajlo')
ŝedo = ŝirmejo, kabano 
ŝekelo = siklo
ŝerifo = oficulo (en Britujo la rolo de "ŝerifo" havas tre varian enhavon, ofte nur ceremonia), (eksterurba) policestro (en Usono)
ŝiboleto (en ĝenerala senco) = rekonvorto, rekonilo
ŝlagro = sukcesa kanto, furoraĵo 
ŝlemilo = malbonŝanculo
ŝli = ri = ŝi aŭ li, ŝili
ŝorbeto = fruktoglaciaĵo 
ŝorto = pantaloneto, femurpantalono, mallonga pantalono
ŝoso = branĉido, ĝermo
ŝoseo = veturvojo, vojo, vojo por aŭtomobiloj
ŝoti = pafi, pafĵeti (pilkon au similan aĵon cele al golejo aŭ simile)
ŝpalo = fervoja breto 
ŝpato = plata fosilo 
ŝproso = sulkobreto 
ŝpuro = fervoja larĝo 
ŝriki = akute krii 
ŝtato = (en la senco de ĝenerala kunveno de delegitoj, kiel en 'Ŝtatoj Ĝeneralaj de Francujo') delegitaro, parlament-o
ŝutro = fenestrokovrilo, fenestroŝirmilo 
ŝvabri = lavbalai
tabernaklo = (sub-)tenda templo, sanktejo, (en nuntempaj preĝejoj) hostiuja ŝranketo, (juda festo) laŭboj
tablojdo = (plata) pilolo
taĉo = flanka linio
tahino = sezama pasto
tajfuno = tropika marŝtormo
tajĝio = tajĝia batalarto, tajĝibatalarto 
tajĝiĉuano = tajĝia batalarto, tajĝibatalarto 
tajpi = enklavi, maŝinskribi 
taki- = rapid-, rapida, rapide
taki = ŝanĝi ventoflankon, vele) zigzagi kontraŭvente
takigrafo = rapidoregistrilo
takikardio = kororapido, rapida korpulsado, korrapido, rapida korbatado
takimetro = rapidomezurilo
takipneo = rapidega spirado
takso = imposto
taksio = altirforpuŝa reago
taksimetro = (taksia) (vetur-)prezoindikilo
taksono = enklasigunuo
taksonomio = enklasigscienco
taktismo = altirforpuŝa reago
talibano = talibo
talono = ĉekstumpo
talvego = valfunda linio, akvokolekta linio
tampono = ŝtopvato 
tantiemo = elcentaĵa pago, pago pro aŭtorrajto, parta profito pro verko 
tapiserio = tapiŝo 
tarda = malfrua
tartali = balbuti, ripetbalbuti 
taŭro = virbovo 
taŭtologio = signifripeto, samvortripeto 
taverno = trinkejo, gastejo
tekniko = teĥniko
teĥnologio = teĥnikoscienco, teĥnikaro (laŭ la kuntekstoj)
teismo = diismo, dikredo, kredo je la ekzisto de interaganta dio
teko = dokumentujo, valizeto, paperujo, mansako
tekokomputilo = portebla komputilo, klapokomputilo
teknopatio = labormalsano
tekstila = teksaĵa, ŝtofa
telefonio = telefona fako
telencefalo = grandcerbo, egcerbo, granda cerbo
telekomandilo = defora regilo, defora ŝaltilo
telepatio = mensinterkomunikado, menslegado
televizio = televida kompanio, televido, televidilo
telfero = kablovojo
tembro = tonkoloro, sonkvalito 
temerara = sentima
temporalo = tempia osto
tenaca = malrompiĝema
tenajlo = (por aparta speco de metiistaj pinĉiloj) tirpinĉilo; (ĝenerale por metiistaj pinĉiloj) (metiista) pinĉilo
tendro = karbovagono de vaporlokomotivo 
tenebro = mallumo
tenera = delikata, varmsenta
tenso = (gramatika) tempo 
teogonio = dia genealogio, naskolisto de la dioj
teologio = distudo, discienco, diesploro
teologo = difakulo, disciencisto, diesploranto
teokrato = religireganto
teokratio = religirego
tepida = varmeta, duonvarma 
ĉeftero = kontinenta tero, firma tero 
tera- = milmiliardo 
terapio = kuraco, kuracado, kuracrimedo
terato = monstro
teratogena = monstroprodukta
teratologio = studo pri nenormaĵoj
teratatomo = malsimpla tumoro
terceto = (en la senco de tri kun-ludantoj aŭ kun-kantantoj) tri-op-o, tri-o; (en la senco de verko por tri) tri-op-aĵ-o 
tercio = tria intervalo, trito. Vidu ssv plio 9.
terciana = triataga (febro)
terciara = triavica, triaranga
termika = varma, kontraŭvarma, foje varmkonserva 
terminalo = (en flug-haveno) flugstacio, (pri komputiloj) finaparato
terminologio = terminscienco, terminstudo, (en la senco de 'terminaro') terminaro
termio = (korpo-)temperaturo, (korpo-)varmo
termo- = varmo, varma
termobotelo = varmobotelo, varmizola botelo
termoj = varmbanejoj (en la antikva Romo)
termodinamiko = varmoscienco
termometro = varmomezurilo, temperaturmezurilo
termometrio = varmomezurado
termoso = varmobotelo, varmizola botelo
termosifono = radiatoro, hejtilo
ternara = trielementa, triparta
tetra- = kvar-
tetrarko = kvaronestro, kvaronreganto, regokvaropano, kunimperiestro
tetrarkio = kvaropa kunregado; regokvaropo
tildo = (kiel memstara signo) ondosigno; (kiel supersigno) = onda supersigno
timida = timema, sinĝena, malaplomba, hontema 
timpano = aŭdmembrano; (en la PIV-a signifo) mezorela kavo 
tino = (ligna) kuvo
tiom = tiom multe
tiparo = literaro 
tipografo = presisto
tipografio = = presarto, presejo (laŭ la kunteksto)
tiraljoro = (armea) celpafisto, kaŝpafisto
tizano = infuzaĵo
tlaspo = monera herbo
toasto = rostpano, rostita pano, rostitaa pantranĉo, 
tobogano = sledeto; glitejo (laŭ la senco en la konkreta situacio)
Togolo = Togolando
Toĥaro = la toĥara (lingvo)
tokpisino = la tokpisina lingvo
toksa = venena
toksi = veneni, eniigi venenon
toksino = (mikroba) veneno, (mikroba) venensubstanco
tokso = veneno, venena substanco
toksomanio = drogomisuzo
toksologio = venenscienco, venenmedicino
toleranco = tolero, akcepteblo
-tomo = (kuracista) tranĉilo
-tomio = operacio
-tomizi = operacii
tonalo = tonkombino 
topiko = (en la senco de ‘temo’) temo; (en la senco de ‘loko’) loko
toplisto = listo de plej ofte rigardataj paĝoj, pintolisto
topografo = mapsciencisto
topografio = mapscienco
toponimo = loknomo
toponimio = loknomoscienco
toporo = hakilo
toreado = bovbatalludo
toreadoro = bovbatalisto
toreisto = bovbatalisto
torento = monta rivereto, kruta rivereto, impeta akvofluo.
tornado = ventego, kirla vento, funela vento
tornistro = dorsosako 
torporo = malvigleco, malagemo, dormemo
tortikolo = koltordiĝo, kola rigido, koldoloro
totala = tuta, entuta, ĉioma, plena, kompleta
totalismo = tutismo, totalitarismo
totalisma = tutisma, totalitara
trabanto = satelito
tragika = tragedia
tragikomedio = tragedia komedio, ridiga tragedio, serioza-malserioza teatraĵo
trajno = vagonaro
traktato = interŝtata kontrakto, interŝtata interkonsento 
trampo = vagabondo, vagulo, vaganto, senhejmulo, ĉifonulo (se temas pri homo), vaganta ŝipo aŭ aviadilo (se temas pri ŝipoj aŭ aviadiloj)
trampolino = resaltotuko, (re)saltigilo, saltotapiŝo, saltolito, saltotuko (la lasta alternativo kunfuzeblas kun la fajrobrigardaj saltotukoj neresaltigaj)
transformatoro (pri elektro) = transformilo
transfuzi = sangaldono
transitiva (verbo) = transira
transmisii = transigi, transsendi, peri, komuniki
transpiri = ŝviti, spiri (por plantoj) 
traŭmato = (en psikologio) traŭmo; (en la ĝenerala medicino) vundo
traŭmatologo = vundokuracisto, vundosciencisto
traŭmatologio = vundoscienco, vundokuracado
traŭbo = vinbero
travestii = alivesti, (en literaturo) komike imiti, parodii 
trefo = trifolio 
trenco = trancomuziko
trenda = laŭmoda
trendo = evolutendenco, modo
triciklo = triradilo, trirad(a )biciklo
triĥo- = haro
triĥomicetozo = miceta harmalsano
triĥopatio = harmalsano
triĥoplazio = nenormala harkreskado
triĥozo = okula harmalsano(en sciencaj vortoj) = haro
trikomicetozo = miceta harmalsano
trikopatio = harmalsano
trikoplazio = nenormala harkreskado
trikozo = okula harmalsano
trilogio = triparta romano, triopo, trilibra serio, librotriopo, triserio, dramaro, dramtriopo (en la origina greka senco)
trimestro = tri monatoj, trimonata periodo, jarkvarono; (pro influo de naciaj lingvoj, foje la intencata signifo povas esti alia, kaj tiam oni devas traduki laŭ la efektiva signifo)
trinkmono = dankmono
trista = malgaja, malĝoja, malĝojeta
trivi = eluzi 
trojko = triopo, (en la senco de estraro) tripersona estraro, triopa estraro
trolo = marfunda trenreto/tirreto
tropo = vortfiguro, stilfiguro
tropismo (en la senco de reago al altira aŭ forpuŝ forto) = altirforpuŝa reago
trotuaro = paŝvojo, paŝejo, homvojo, porhoma vojo
trovi = konsideri, opinii
tuĉo = ĉina inko 
turneo (teatro) = rondiro
turpa = malbela, malbelega
uako = ĉina pato, kurba pato, uoko
ubikva = multmedia
ublieto = forgeskelo, punkelo
uesto = okcidento
ujutna = ĉarma, komforta, bonfarta
-uk- = kastrita
ukazo = (cara) dekreto, arbitra ordono
ulno = kubutosto
ultimato = lasta oferto
ultra = trans, eg, ekstrema
ultramaro = intense/malhele blua farbo/kolorilo, ĉielblua farbo/kolorilo, ĉielbluo.
ultraviola = transviola
ululi = ĝembojegi (de hundoj aŭ lupoj), (strige) bleki (de strigoj)), (plor)kriegi (lamentantaj homoj), (ĝoj-)kriegi (ĝojantaj homoj), kriegi (kantistoj).
umiko = amamiko
un' = unu
undino = akvofeino
ungvento = ŝmiraĵo
unio = unuiĝo
unika = (unu) sola
unikorno = unukornulo
unito = unuo
unkti = sanktolei, ŝmiri (per oleo)
unuciklo = unuradilo, unurad(a )biciklo
unusencuma = unudirekta (strato)
uoko = ĉina pato, kurba pato
uranismo = ambaŭseksemo, (vira) samseksemo
urbanizi = urb-(ec-)igi
urduo = la urdua lingvo
uretro = urinkanalo
urlio = mumpso, salivglanda inflamo/ŝvelo, (ĉe-)orelglanda inflamo/ŝvelo
utrikulario = vezika herbo
uverturo = (muzika) malfermo 
uvo = vinbero 
uzanco = uzo, uzado, uzkutimo
uzino = fabriko, (meĥanikista) riparejo, metalprilaborejo
uzurpatoro = uzurpanto, uzurpinto (laŭ la kunteksto)
ŭesto = okcidento
V = 5, 5a 
vaĉi = gardi, gardostari
vademekumo = manlibro, gvidlibro, poŝhelplibr(et)o. 
vado = tajdofundo, deflusekfundo 
vafro = vaflo
vagabondo = vagulo, vaganto
vajco = ŝraŭbtenilo, ŝraŭbmakzelo
vaka = malplena
vakero = rajd•paŝt•ist•o, (rajdanta) bovisto/bovgardisto
valer- = valerat-
valerato = salo de valeriana acido
valeto = (vir-)ĉambristo 
valga = kurbakrura 
valuto = monunuo
vampo = vampirino
vanui = malaperi
variablo = varianto
varianto = variaĵo
varietato = variaĵo 
varieteo = varia spektaklo, varia amuzaĵo, amuzkantejo 
varleto = tenpeco
varmobotelo = varmakva sako 
varpo = laŭlonga (tekso-)fadenaro
vasko = (fontana) konkego
vatro = varmtransigilo, hejtilo 
vavo = duobla vo (nomo de la litero w)
vazistaso = klapfenestro, klapo, fenestroklapo
vefto = laŭlarĝa (tekso-)fadenaro, interkruciĝanta (tekso-)fadenaro
vego = kurejo, vojo (en vojo)
vegano = senbestaĵisto
veganismo = senbestaĵismo, dieto senbestaĵa, dieto nurkreskaĵa
vegetalo = kreskaĵo
vegetaĵo = kreskaĵo
vegetalano = senbestaĵisto
vegetara = senvianda, senviandisma
vegetarano = senviandisto
vegetarismo = senviandismo, dieto senvianda
vegetaranismo = senviandismo, vegetarismo
vehiklo = (laŭ la signifo en la unuopa okazo) perilo, veturilo, portilo, infektportanto, helpilo, ilo
veka = vekita, sendorma, maldorma
veksilo = flago
veksilologio = flagoscienco
velaro = vela konsonanto
veldi = fande kunfiksi
vendeto = familia venĝo
venerea = venusa
Venera = Venuso
veneri = respektegi
ventgeneratoro = venta generilo
ventilatoro = ventolilo
venusa monto = puba monto
vepro = pikarbusto, densejo, arbustaĵo
verbo = ivorto, agvorto, farvorto
verbesino = verbezeno
vermifugo = vermoforigilo, vermomortigilo, kontraŭvermaĵo
vernalizi = antaŭmaturigi
versalo = eta granda litero, granda litero, duongranda litero
versiklo = versego, verso, paragrafeto, linio, ĉapitrero, tekstunuo, instiga verso (en liturgio la verso, kiu postulas respondan verson)
vertago = melhundo
vertico = pinto, verto, angulpunkto, nodo, nodpunkto (ĉi tiuj du lastaj rilate al 'grafeo-j')
vertrago = leporhundo 
veselo = antikva (milit-)ŝipo 
vespereo = vespera prezentado 
vespro = vespera diservo
vesterno = usonokcidenta filmo, sovaĝokcidenta filmo, bovgardista filmo 
vestiblo = enirĉambro
vestiĝo = spuro, restaĵo
veterinaro = bestkuracisto 
VI = 6, 6a 
vibracio = vibro
vibriso = (ĉe bestoj) sentharo, (se surlipe, ankaŭ) lipharo; (ĉe homo) nazharo 
vicpatrino = duonpatrino
vicrado (aŭtomobilo) = kromrado 
video = vidbendo, (vidbenda, diska) filmo
video- = vid-, film-, (parolante pri parto de elektronika aparataro) bildiga
videoklipo = filmeto, muzikfilm-(et)-o
vigili = noktogardi, gardi
VII = 7, 7a 
VIII = 8, 8a 
viktualio = nutroprovizoj
vilao = (solstara) luksa domo; (en la roma regno) biendomo
villo = vilao
vimplo = flageto
vinĉo = ŝnurvolva levilo
vindaso = ankrolevilo, volvakso
vinjeto = bildŝerco
vinkto = kunkroĉilo 
vinkulo = kuniga krampo, kurba krampo
vinologo vinfakulo, vinsciencisto
violenta = perfort(em)a 
violenti = (sekse) perforti, seksatenci
vipero = vipuro [fun]
virozo = virusmalsano
virulenta = malsaniga, (akre) atakema, vive malutila
viskoza = malflua, malfluema, flumalema
viskozo = malfluo, malfluemo, flumalemo
viskozometro = malfluomezurilo
vito = vinberujo
vitala = viveca, viva
vitralo = vitrofenestrego, vitromozaika fenestro
vitrino = montrofenestro
vivario = vivujo
vizio = vido, antaŭvido, imago
vizuala = vida 
vobli = ŝanceliĝi 
vojevodio = pola provinco
vokalisto = voĉisto, kantisto
vokto = supergardisto, inspektisto
volano = plumpilko
volatila = gasiĝema 
volbo = (plafona) arkaĵo [fun]
volbopato = ĉina pato
volejbalo = retpilko 
voltmetro = voltmezurilo
voluto = spirala ornamaĵo
vomito = flava febro 
vori = manĝegi
vorko = konstruaĵo, konstruado, konstruejo 
voti = voĉdoni
vrako = ŝip/flugmaŝinrestaĵo
vringi = premtordi
vuajerismo = (seks-)rigardismo
vuajerismulo = kaŝrigardanto, ŝtelrigardanto, seksrigardanto, (seks-)rigardulo
vulkanizi = sulfurumi (kaŭĉukon)
vursto = (dika / germanspeca) kolbas(et)o
X = 10, 10-a 
XI = 11, 11-a 
XII = 12, 12-a 
XIII = 13, 13-a 
XIV = 14, 14-a 
XV = 15, 15-a 
XVI = 16, 16-a 
XVII = 17, 17-a 
XVIII = 18, 18-a 
XIX = 19, 19-a 
zabajono = ovoflavaĵo
zapi = kanalumi 
zenano = virina domparto
zepelino = (rigidframa) aerŝipo.
zigomo = vangosto
zipi = densigi, kompaktigi
zipo = tirfermilo
zo- = best-
zomi = skali (per objektivo), (en aviado) = malrapidiĝe altiĝi
zomilo = skalobjektivo
zomo = skalado (per objektivo), (en aviado) malrapidiĝa altiĝo, skalobjektivo (por tiuj, kiuj konsideras la radikon zom- substantiva)
zono = zostero
zoo = bestĝardeno 
zoologio = bestscienco 
zoologo = zoologiisto, bestsciencisto
zoomorfa = bestforma
zootekniko = bestteĥniko, bestbredteĥniko, bredteĥniko
zostero = zona herpeto, zonerupcio
